ITTER107,Region,Age,Males_value,Females_value,Population_value
ITC1,Piemonte,0,14418,14075,28493
ITC1,Piemonte,1,15605,15112,30717
ITC1,Piemonte,2,16367,15649,32016
ITC1,Piemonte,3,17114,15722,32836
ITC1,Piemonte,4,17482,16707,34189
ITC1,Piemonte,5,18074,17037,35111
ITC1,Piemonte,6,18785,17680,36465
ITC1,Piemonte,7,19128,17655,36783
ITC1,Piemonte,8,19356,18246,37602
ITC1,Piemonte,9,19883,18815,38698
ITC1,Piemonte,10,20153,18847,39000
ITC1,Piemonte,11,20038,18897,38935
ITC1,Piemonte,12,19732,18601,38333
ITC1,Piemonte,13,19634,18459,38093
ITC1,Piemonte,14,19725,18339,38064
ITC1,Piemonte,15,19722,18470,38192
ITC1,Piemonte,16,19208,18438,37646
ITC1,Piemonte,17,19424,18293,37717
ITC1,Piemonte,18,20405,18838,39243
ITC1,Piemonte,19,20536,18327,38863
ITC1,Piemonte,20,21246,18598,39844
ITC1,Piemonte,21,20799,18866,39665
ITC1,Piemonte,22,20696,18404,39100
ITC1,Piemonte,23,20519,18588,39107
ITC1,Piemonte,24,20496,18995,39491
ITC1,Piemonte,25,20712,19283,39995
ITC1,Piemonte,26,21390,19940,41330
ITC1,Piemonte,27,21547,20280,41827
ITC1,Piemonte,28,22277,20760,43037
ITC1,Piemonte,29,21853,20654,42507
ITC1,Piemonte,30,22479,21368,43847
ITC1,Piemonte,31,21657,21237,42894
ITC1,Piemonte,32,22290,21458,43748
ITC1,Piemonte,33,22740,22277,45017
ITC1,Piemonte,34,22695,22575,45270
ITC1,Piemonte,35,23538,23229,46767
ITC1,Piemonte,36,24514,24205,48719
ITC1,Piemonte,37,24426,24440,48866
ITC1,Piemonte,38,25133,25149,50282
ITC1,Piemonte,39,25925,25624,51549
ITC1,Piemonte,40,27636,27595,55231
ITC1,Piemonte,41,28872,29261,58133
ITC1,Piemonte,42,30287,30643,60930
ITC1,Piemonte,43,31999,32461,64460
ITC1,Piemonte,44,33664,33687,67351
ITC1,Piemonte,45,33836,33480,67316
ITC1,Piemonte,46,34542,34497,69039
ITC1,Piemonte,47,34753,35332,70085
ITC1,Piemonte,48,34490,34913,69403
ITC1,Piemonte,49,35727,36160,71887
ITC1,Piemonte,50,35436,35947,71383
ITC1,Piemonte,51,35330,36037,71367
ITC1,Piemonte,52,35748,36108,71856
ITC1,Piemonte,53,35383,36152,71535
ITC1,Piemonte,54,35694,36864,72558
ITC1,Piemonte,55,33306,34407,67713
ITC1,Piemonte,56,31805,33382,65187
ITC1,Piemonte,57,31493,33054,64547
ITC1,Piemonte,58,30382,32003,62385
ITC1,Piemonte,59,29899,30979,60878
ITC1,Piemonte,60,28902,30262,59164
ITC1,Piemonte,61,28693,30191,58884
ITC1,Piemonte,62,27905,29654,57559
ITC1,Piemonte,63,27349,29032,56381
ITC1,Piemonte,64,26701,28857,55558
ITC1,Piemonte,65,25869,27693,53562
ITC1,Piemonte,66,25866,27619,53485
ITC1,Piemonte,67,24959,27499,52458
ITC1,Piemonte,68,25864,28731,54595
ITC1,Piemonte,69,26169,28799,54968
ITC1,Piemonte,70,27284,30342,57626
ITC1,Piemonte,71,26635,29577,56212
ITC1,Piemonte,72,25646,28865,54511
ITC1,Piemonte,73,19364,22079,41443
ITC1,Piemonte,74,20378,23728,44106
ITC1,Piemonte,75,19668,23817,43485
ITC1,Piemonte,76,19756,23920,43676
ITC1,Piemonte,77,19364,24227,43591
ITC1,Piemonte,78,20848,26269,47117
ITC1,Piemonte,79,20141,25895,46036
ITC1,Piemonte,80,19096,24864,43960
ITC1,Piemonte,81,16733,22551,39284
ITC1,Piemonte,82,14763,20358,35121
ITC1,Piemonte,83,13898,20227,34125
ITC1,Piemonte,84,12156,18726,30882
ITC1,Piemonte,85,10426,17234,27660
ITC1,Piemonte,86,9285,16208,25493
ITC1,Piemonte,87,8166,15038,23204
ITC1,Piemonte,88,7384,14222,21606
ITC1,Piemonte,89,5686,11884,17570
ITC1,Piemonte,90,4371,10022,14393
ITC1,Piemonte,91,3490,8607,12097
ITC1,Piemonte,92,2488,7026,9514
ITC1,Piemonte,93,1839,5566,7405
ITC1,Piemonte,94,1326,4288,5614
ITC1,Piemonte,95,990,3349,4339
ITC1,Piemonte,96,646,2617,3263
ITC1,Piemonte,97,426,1858,2284
ITC1,Piemonte,98,265,1206,1471
ITC1,Piemonte,99,88,568,656
ITC1,Piemonte,100 and over,138,967,1105
ITC1,Piemonte,Total,2103024,2225541,4328565
ITC2,Valle d'Aosta / Vallée d'Aoste,0,468,416,884
ITC2,Valle d'Aosta / Vallée d'Aoste,1,471,420,891
ITC2,Valle d'Aosta / Vallée d'Aoste,2,503,455,958
ITC2,Valle d'Aosta / Vallée d'Aoste,3,489,480,969
ITC2,Valle d'Aosta / Vallée d'Aoste,4,553,505,1058
ITC2,Valle d'Aosta / Vallée d'Aoste,5,512,520,1032
ITC2,Valle d'Aosta / Vallée d'Aoste,6,576,546,1122
ITC2,Valle d'Aosta / Vallée d'Aoste,7,606,578,1184
ITC2,Valle d'Aosta / Vallée d'Aoste,8,582,581,1163
ITC2,Valle d'Aosta / Vallée d'Aoste,9,636,593,1229
ITC2,Valle d'Aosta / Vallée d'Aoste,10,621,588,1209
ITC2,Valle d'Aosta / Vallée d'Aoste,11,626,590,1216
ITC2,Valle d'Aosta / Vallée d'Aoste,12,657,582,1239
ITC2,Valle d'Aosta / Vallée d'Aoste,13,587,559,1146
ITC2,Valle d'Aosta / Vallée d'Aoste,14,593,582,1175
ITC2,Valle d'Aosta / Vallée d'Aoste,15,591,589,1180
ITC2,Valle d'Aosta / Vallée d'Aoste,16,599,517,1116
ITC2,Valle d'Aosta / Vallée d'Aoste,17,624,557,1181
ITC2,Valle d'Aosta / Vallée d'Aoste,18,641,589,1230
ITC2,Valle d'Aosta / Vallée d'Aoste,19,640,573,1213
ITC2,Valle d'Aosta / Vallée d'Aoste,20,634,564,1198
ITC2,Valle d'Aosta / Vallée d'Aoste,21,589,541,1130
ITC2,Valle d'Aosta / Vallée d'Aoste,22,641,573,1214
ITC2,Valle d'Aosta / Vallée d'Aoste,23,608,559,1167
ITC2,Valle d'Aosta / Vallée d'Aoste,24,574,560,1134
ITC2,Valle d'Aosta / Vallée d'Aoste,25,586,554,1140
ITC2,Valle d'Aosta / Vallée d'Aoste,26,651,587,1238
ITC2,Valle d'Aosta / Vallée d'Aoste,27,614,569,1183
ITC2,Valle d'Aosta / Vallée d'Aoste,28,624,647,1271
ITC2,Valle d'Aosta / Vallée d'Aoste,29,642,576,1218
ITC2,Valle d'Aosta / Vallée d'Aoste,30,649,626,1275
ITC2,Valle d'Aosta / Vallée d'Aoste,31,632,629,1261
ITC2,Valle d'Aosta / Vallée d'Aoste,32,607,646,1253
ITC2,Valle d'Aosta / Vallée d'Aoste,33,655,631,1286
ITC2,Valle d'Aosta / Vallée d'Aoste,34,657,654,1311
ITC2,Valle d'Aosta / Vallée d'Aoste,35,699,689,1388
ITC2,Valle d'Aosta / Vallée d'Aoste,36,674,723,1397
ITC2,Valle d'Aosta / Vallée d'Aoste,37,669,674,1343
ITC2,Valle d'Aosta / Vallée d'Aoste,38,761,680,1441
ITC2,Valle d'Aosta / Vallée d'Aoste,39,740,704,1444
ITC2,Valle d'Aosta / Vallée d'Aoste,40,872,829,1701
ITC2,Valle d'Aosta / Vallée d'Aoste,41,834,812,1646
ITC2,Valle d'Aosta / Vallée d'Aoste,42,854,921,1775
ITC2,Valle d'Aosta / Vallée d'Aoste,43,902,950,1852
ITC2,Valle d'Aosta / Vallée d'Aoste,44,996,965,1961
ITC2,Valle d'Aosta / Vallée d'Aoste,45,996,1009,2005
ITC2,Valle d'Aosta / Vallée d'Aoste,46,989,1035,2024
ITC2,Valle d'Aosta / Vallée d'Aoste,47,1029,1076,2105
ITC2,Valle d'Aosta / Vallée d'Aoste,48,1014,1050,2064
ITC2,Valle d'Aosta / Vallée d'Aoste,49,1080,1124,2204
ITC2,Valle d'Aosta / Vallée d'Aoste,50,1046,1081,2127
ITC2,Valle d'Aosta / Vallée d'Aoste,51,1070,1110,2180
ITC2,Valle d'Aosta / Vallée d'Aoste,52,1104,1104,2208
ITC2,Valle d'Aosta / Vallée d'Aoste,53,1071,1064,2135
ITC2,Valle d'Aosta / Vallée d'Aoste,54,1160,1121,2281
ITC2,Valle d'Aosta / Vallée d'Aoste,55,1069,1025,2094
ITC2,Valle d'Aosta / Vallée d'Aoste,56,941,989,1930
ITC2,Valle d'Aosta / Vallée d'Aoste,57,988,936,1924
ITC2,Valle d'Aosta / Vallée d'Aoste,58,853,905,1758
ITC2,Valle d'Aosta / Vallée d'Aoste,59,909,956,1865
ITC2,Valle d'Aosta / Vallée d'Aoste,60,826,856,1682
ITC2,Valle d'Aosta / Vallée d'Aoste,61,815,851,1666
ITC2,Valle d'Aosta / Vallée d'Aoste,62,805,806,1611
ITC2,Valle d'Aosta / Vallée d'Aoste,63,763,867,1630
ITC2,Valle d'Aosta / Vallée d'Aoste,64,777,830,1607
ITC2,Valle d'Aosta / Vallée d'Aoste,65,797,778,1575
ITC2,Valle d'Aosta / Vallée d'Aoste,66,751,750,1501
ITC2,Valle d'Aosta / Vallée d'Aoste,67,737,780,1517
ITC2,Valle d'Aosta / Vallée d'Aoste,68,745,771,1516
ITC2,Valle d'Aosta / Vallée d'Aoste,69,755,834,1589
ITC2,Valle d'Aosta / Vallée d'Aoste,70,764,842,1606
ITC2,Valle d'Aosta / Vallée d'Aoste,71,759,747,1506
ITC2,Valle d'Aosta / Vallée d'Aoste,72,694,747,1441
ITC2,Valle d'Aosta / Vallée d'Aoste,73,501,603,1104
ITC2,Valle d'Aosta / Vallée d'Aoste,74,582,590,1172
ITC2,Valle d'Aosta / Vallée d'Aoste,75,602,632,1234
ITC2,Valle d'Aosta / Vallée d'Aoste,76,577,642,1219
ITC2,Valle d'Aosta / Vallée d'Aoste,77,546,676,1222
ITC2,Valle d'Aosta / Vallée d'Aoste,78,562,698,1260
ITC2,Valle d'Aosta / Vallée d'Aoste,79,516,654,1170
ITC2,Valle d'Aosta / Vallée d'Aoste,80,509,665,1174
ITC2,Valle d'Aosta / Vallée d'Aoste,81,414,591,1005
ITC2,Valle d'Aosta / Vallée d'Aoste,82,363,530,893
ITC2,Valle d'Aosta / Vallée d'Aoste,83,330,492,822
ITC2,Valle d'Aosta / Vallée d'Aoste,84,270,467,737
ITC2,Valle d'Aosta / Vallée d'Aoste,85,267,470,737
ITC2,Valle d'Aosta / Vallée d'Aoste,86,222,408,630
ITC2,Valle d'Aosta / Vallée d'Aoste,87,209,385,594
ITC2,Valle d'Aosta / Vallée d'Aoste,88,191,392,583
ITC2,Valle d'Aosta / Vallée d'Aoste,89,152,303,455
ITC2,Valle d'Aosta / Vallée d'Aoste,90,121,275,396
ITC2,Valle d'Aosta / Vallée d'Aoste,91,78,237,315
ITC2,Valle d'Aosta / Vallée d'Aoste,92,63,195,258
ITC2,Valle d'Aosta / Vallée d'Aoste,93,60,143,203
ITC2,Valle d'Aosta / Vallée d'Aoste,94,28,103,131
ITC2,Valle d'Aosta / Vallée d'Aoste,95,22,92,114
ITC2,Valle d'Aosta / Vallée d'Aoste,96,15,79,94
ITC2,Valle d'Aosta / Vallée d'Aoste,97,11,64,75
ITC2,Valle d'Aosta / Vallée d'Aoste,98,6,33,39
ITC2,Valle d'Aosta / Vallée d'Aoste,99,4,15,19
ITC2,Valle d'Aosta / Vallée d'Aoste,100 and over,4,21,25
ITC2,Valle d'Aosta / Vallée d'Aoste,Total,61471,64182,125653
ITC3,Liguria,0,4531,4277,8808
ITC3,Liguria,1,4959,4633,9592
ITC3,Liguria,2,5144,4737,9881
ITC3,Liguria,3,5184,4958,10142
ITC3,Liguria,4,5605,5202,10807
ITC3,Liguria,5,5681,5263,10944
ITC3,Liguria,6,5920,5631,11551
ITC3,Liguria,7,5841,5535,11376
ITC3,Liguria,8,6049,5820,11869
ITC3,Liguria,9,6246,6184,12430
ITC3,Liguria,10,6446,6224,12670
ITC3,Liguria,11,6514,5903,12417
ITC3,Liguria,12,6417,6169,12586
ITC3,Liguria,13,6495,6019,12514
ITC3,Liguria,14,6437,6150,12587
ITC3,Liguria,15,6413,5948,12361
ITC3,Liguria,16,6540,6116,12656
ITC3,Liguria,17,6532,6242,12774
ITC3,Liguria,18,6845,6239,13084
ITC3,Liguria,19,6970,6063,13033
ITC3,Liguria,20,7119,6184,13303
ITC3,Liguria,21,7007,6259,13266
ITC3,Liguria,22,7278,6239,13517
ITC3,Liguria,23,6921,6269,13190
ITC3,Liguria,24,6877,6372,13249
ITC3,Liguria,25,7036,6543,13579
ITC3,Liguria,26,7445,6794,14239
ITC3,Liguria,27,7157,6887,14044
ITC3,Liguria,28,7208,6928,14136
ITC3,Liguria,29,7164,6954,14118
ITC3,Liguria,30,7362,7137,14499
ITC3,Liguria,31,7331,6833,14164
ITC3,Liguria,32,7188,6841,14029
ITC3,Liguria,33,7428,7175,14603
ITC3,Liguria,34,7433,7182,14615
ITC3,Liguria,35,7632,7297,14929
ITC3,Liguria,36,7640,7302,14942
ITC3,Liguria,37,7820,7796,15616
ITC3,Liguria,38,7727,7697,15424
ITC3,Liguria,39,7946,8269,16215
ITC3,Liguria,40,8525,8984,17509
ITC3,Liguria,41,9139,9424,18563
ITC3,Liguria,42,9793,9943,19736
ITC3,Liguria,43,10443,10660,21103
ITC3,Liguria,44,11056,11508,22564
ITC3,Liguria,45,11404,11562,22966
ITC3,Liguria,46,12014,12208,24222
ITC3,Liguria,47,12105,12301,24406
ITC3,Liguria,48,12032,12591,24623
ITC3,Liguria,49,12376,12801,25177
ITC3,Liguria,50,12608,12866,25474
ITC3,Liguria,51,12244,13042,25286
ITC3,Liguria,52,12929,13433,26362
ITC3,Liguria,53,13155,13664,26819
ITC3,Liguria,54,13373,13700,27073
ITC3,Liguria,55,12353,13090,25443
ITC3,Liguria,56,11863,12626,24489
ITC3,Liguria,57,11479,12232,23711
ITC3,Liguria,58,11109,11778,22887
ITC3,Liguria,59,10987,11707,22694
ITC3,Liguria,60,10410,11280,21690
ITC3,Liguria,61,10414,11020,21434
ITC3,Liguria,62,10068,10795,20863
ITC3,Liguria,63,9625,10544,20169
ITC3,Liguria,64,9640,10471,20111
ITC3,Liguria,65,9228,10236,19464
ITC3,Liguria,66,8930,9877,18807
ITC3,Liguria,67,8776,10003,18779
ITC3,Liguria,68,9474,10514,19988
ITC3,Liguria,69,9334,10875,20209
ITC3,Liguria,70,9937,11349,21286
ITC3,Liguria,71,10034,11765,21799
ITC3,Liguria,72,9947,11907,21854
ITC3,Liguria,73,7183,8562,15745
ITC3,Liguria,74,7981,9696,17677
ITC3,Liguria,75,7672,9414,17086
ITC3,Liguria,76,7632,9827,17459
ITC3,Liguria,77,7781,10014,17795
ITC3,Liguria,78,8209,10719,18928
ITC3,Liguria,79,7824,10494,18318
ITC3,Liguria,80,7402,10224,17626
ITC3,Liguria,81,6569,9346,15915
ITC3,Liguria,82,5760,8561,14321
ITC3,Liguria,83,5413,8271,13684
ITC3,Liguria,84,4860,7630,12490
ITC3,Liguria,85,4411,7225,11636
ITC3,Liguria,86,3873,6987,10860
ITC3,Liguria,87,3450,6472,9922
ITC3,Liguria,88,3121,6209,9330
ITC3,Liguria,89,2480,5277,7757
ITC3,Liguria,90,2018,4496,6514
ITC3,Liguria,91,1609,3788,5397
ITC3,Liguria,92,1163,3189,4352
ITC3,Liguria,93,905,2607,3512
ITC3,Liguria,94,659,2062,2721
ITC3,Liguria,95,457,1647,2104
ITC3,Liguria,96,335,1266,1601
ITC3,Liguria,97,220,893,1113
ITC3,Liguria,98,137,664,801
ITC3,Liguria,99,49,300,349
ITC3,Liguria,100 and over,78,570,648
ITC3,Liguria,Total,733543,799437,1532980
ITC4,Lombardia,0,38643,36462,75105
ITC4,Lombardia,1,40748,38368,79116
ITC4,Lombardia,2,41883,39992,81875
ITC4,Lombardia,3,43644,41051,84695
ITC4,Lombardia,4,44503,42358,86861
ITC4,Lombardia,5,45611,42922,88533
ITC4,Lombardia,6,47314,44601,91915
ITC4,Lombardia,7,48372,45415,93787
ITC4,Lombardia,8,49952,46511,96463
ITC4,Lombardia,9,50774,47918,98692
ITC4,Lombardia,10,50685,47948,98633
ITC4,Lombardia,11,50215,47226,97441
ITC4,Lombardia,12,50489,47300,97789
ITC4,Lombardia,13,49305,46158,95463
ITC4,Lombardia,14,49024,46754,95778
ITC4,Lombardia,15,48457,45255,93712
ITC4,Lombardia,16,47811,44657,92468
ITC4,Lombardia,17,48347,45187,93534
ITC4,Lombardia,18,49566,45632,95198
ITC4,Lombardia,19,49538,44933,94471
ITC4,Lombardia,20,50850,44754,95604
ITC4,Lombardia,21,50216,44876,95092
ITC4,Lombardia,22,49525,44914,94439
ITC4,Lombardia,23,48715,44610,93325
ITC4,Lombardia,24,48781,45378,94159
ITC4,Lombardia,25,49448,46560,96008
ITC4,Lombardia,26,51158,48344,99502
ITC4,Lombardia,27,51535,49190,100725
ITC4,Lombardia,28,53019,50973,103992
ITC4,Lombardia,29,53270,51916,105186
ITC4,Lombardia,30,55515,53251,108766
ITC4,Lombardia,31,54375,52893,107268
ITC4,Lombardia,32,54955,53567,108522
ITC4,Lombardia,33,56752,55676,112428
ITC4,Lombardia,34,58414,56924,115338
ITC4,Lombardia,35,59784,58770,118554
ITC4,Lombardia,36,62309,61000,123309
ITC4,Lombardia,37,62898,61407,124305
ITC4,Lombardia,38,64208,62848,127056
ITC4,Lombardia,39,65930,64453,130383
ITC4,Lombardia,40,69969,67883,137852
ITC4,Lombardia,41,72933,70872,143805
ITC4,Lombardia,42,75778,73595,149373
ITC4,Lombardia,43,80575,78582,159157
ITC4,Lombardia,44,83326,80789,164115
ITC4,Lombardia,45,82882,81172,164054
ITC4,Lombardia,46,84016,81532,165548
ITC4,Lombardia,47,84284,81254,165538
ITC4,Lombardia,48,83234,80899,164133
ITC4,Lombardia,49,84965,83398,168363
ITC4,Lombardia,50,84721,82786,167507
ITC4,Lombardia,51,83986,83025,167011
ITC4,Lombardia,52,85850,84179,170029
ITC4,Lombardia,53,84689,83850,168539
ITC4,Lombardia,54,84021,83241,167262
ITC4,Lombardia,55,77674,78643,156317
ITC4,Lombardia,56,73451,74848,148299
ITC4,Lombardia,57,70905,72700,143605
ITC4,Lombardia,58,68154,70372,138526
ITC4,Lombardia,59,65673,68850,134523
ITC4,Lombardia,60,62643,65384,128027
ITC4,Lombardia,61,61057,64299,125356
ITC4,Lombardia,62,59841,63274,123115
ITC4,Lombardia,63,57275,62137,119412
ITC4,Lombardia,64,56219,60549,116768
ITC4,Lombardia,65,54231,58398,112629
ITC4,Lombardia,66,53512,58479,111991
ITC4,Lombardia,67,52471,58171,110642
ITC4,Lombardia,68,54643,60287,114930
ITC4,Lombardia,69,54758,60873,115631
ITC4,Lombardia,70,56140,63058,119198
ITC4,Lombardia,71,54010,61045,115055
ITC4,Lombardia,72,54953,62833,117786
ITC4,Lombardia,73,40057,46284,86341
ITC4,Lombardia,74,41828,49739,91567
ITC4,Lombardia,75,40501,49160,89661
ITC4,Lombardia,76,40597,49935,90532
ITC4,Lombardia,77,40363,51035,91398
ITC4,Lombardia,78,43231,54613,97844
ITC4,Lombardia,79,41048,52912,93960
ITC4,Lombardia,80,37972,50871,88843
ITC4,Lombardia,81,32542,45238,77780
ITC4,Lombardia,82,28028,40646,68674
ITC4,Lombardia,83,26769,40723,67492
ITC4,Lombardia,84,23271,37392,60663
ITC4,Lombardia,85,20183,34564,54747
ITC4,Lombardia,86,17807,32233,50040
ITC4,Lombardia,87,15375,29451,44826
ITC4,Lombardia,88,13205,27533,40738
ITC4,Lombardia,89,10297,23250,33547
ITC4,Lombardia,90,8074,20024,28098
ITC4,Lombardia,91,6313,16945,23258
ITC4,Lombardia,92,4710,13762,18472
ITC4,Lombardia,93,3459,11341,14800
ITC4,Lombardia,94,2444,9075,11519
ITC4,Lombardia,95,1864,6951,8815
ITC4,Lombardia,96,1150,5080,6230
ITC4,Lombardia,97,781,3871,4652
ITC4,Lombardia,98,510,2617,3127
ITC4,Lombardia,99,195,1232,1427
ITC4,Lombardia,100 and over,250,1946,2196
ITC4,Lombardia,Total,4902201,5108632,10010833
ITD3,Veneto,0,18005,17069,35074
ITD3,Veneto,1,18949,17787,36736
ITD3,Veneto,2,19574,18412,37986
ITD3,Veneto,3,20020,19083,39103
ITD3,Veneto,4,20660,19837,40497
ITD3,Veneto,5,21354,20235,41589
ITD3,Veneto,6,22457,21252,43709
ITD3,Veneto,7,22745,21673,44418
ITD3,Veneto,8,23639,22188,45827
ITD3,Veneto,9,23984,22576,46560
ITD3,Veneto,10,24404,23136,47540
ITD3,Veneto,11,24028,22946,46974
ITD3,Veneto,12,24214,22793,47007
ITD3,Veneto,13,24112,22517,46629
ITD3,Veneto,14,24377,22948,47325
ITD3,Veneto,15,23790,22569,46359
ITD3,Veneto,16,23735,22114,45849
ITD3,Veneto,17,23622,21963,45585
ITD3,Veneto,18,24609,22948,47557
ITD3,Veneto,19,24218,22742,46960
ITD3,Veneto,20,25010,22689,47699
ITD3,Veneto,21,24924,22792,47716
ITD3,Veneto,22,24742,22476,47218
ITD3,Veneto,23,24448,21975,46423
ITD3,Veneto,24,24173,22511,46684
ITD3,Veneto,25,24067,23025,47092
ITD3,Veneto,26,25194,23735,48929
ITD3,Veneto,27,24836,23934,48770
ITD3,Veneto,28,25665,24335,50000
ITD3,Veneto,29,25162,24553,49715
ITD3,Veneto,30,25623,25283,50906
ITD3,Veneto,31,24943,24315,49258
ITD3,Veneto,32,24902,24952,49854
ITD3,Veneto,33,26214,26303,52517
ITD3,Veneto,34,26230,26429,52659
ITD3,Veneto,35,27111,26695,53806
ITD3,Veneto,36,27772,28180,55952
ITD3,Veneto,37,28650,28468,57118
ITD3,Veneto,38,29790,28941,58731
ITD3,Veneto,39,30852,30474,61326
ITD3,Veneto,40,32996,32610,65606
ITD3,Veneto,41,33948,33995,67943
ITD3,Veneto,42,35874,35293,71167
ITD3,Veneto,43,37775,37049,74824
ITD3,Veneto,44,40060,39512,79572
ITD3,Veneto,45,39833,39156,78989
ITD3,Veneto,46,40748,39412,80160
ITD3,Veneto,47,40846,40356,81202
ITD3,Veneto,48,41066,40228,81294
ITD3,Veneto,49,42117,41310,83427
ITD3,Veneto,50,41402,41112,82514
ITD3,Veneto,51,41844,41299,83143
ITD3,Veneto,52,42094,41721,83815
ITD3,Veneto,53,42106,41729,83835
ITD3,Veneto,54,41968,42462,84430
ITD3,Veneto,55,39353,39687,79040
ITD3,Veneto,56,37855,38209,76064
ITD3,Veneto,57,36878,37525,74403
ITD3,Veneto,58,34693,35587,70280
ITD3,Veneto,59,34447,35322,69769
ITD3,Veneto,60,32046,33326,65372
ITD3,Veneto,61,31380,32511,63891
ITD3,Veneto,62,30489,32184,62673
ITD3,Veneto,63,29226,31064,60290
ITD3,Veneto,64,28934,30317,59251
ITD3,Veneto,65,27890,29259,57149
ITD3,Veneto,66,27126,28959,56085
ITD3,Veneto,67,26782,28328,55110
ITD3,Veneto,68,27350,29971,57321
ITD3,Veneto,69,27117,29252,56369
ITD3,Veneto,70,27475,30236,57711
ITD3,Veneto,71,26601,29482,56083
ITD3,Veneto,72,28582,31790,60372
ITD3,Veneto,73,19026,22014,41040
ITD3,Veneto,74,21915,25198,47113
ITD3,Veneto,75,21745,25830,47575
ITD3,Veneto,76,20621,25000,45621
ITD3,Veneto,77,20258,24473,44731
ITD3,Veneto,78,20720,25841,46561
ITD3,Veneto,79,19951,24688,44639
ITD3,Veneto,80,18068,23936,42004
ITD3,Veneto,81,15684,21474,37158
ITD3,Veneto,82,13552,19823,33375
ITD3,Veneto,83,13118,19381,32499
ITD3,Veneto,84,11715,18179,29894
ITD3,Veneto,85,9771,16089,25860
ITD3,Veneto,86,8494,15509,24003
ITD3,Veneto,87,7358,14187,21545
ITD3,Veneto,88,6540,13709,20249
ITD3,Veneto,89,5069,11154,16223
ITD3,Veneto,90,4069,10224,14293
ITD3,Veneto,91,3333,8971,12304
ITD3,Veneto,92,2454,7219,9673
ITD3,Veneto,93,1842,5917,7759
ITD3,Veneto,94,1319,4555,5874
ITD3,Veneto,95,1037,3721,4758
ITD3,Veneto,96,637,2688,3325
ITD3,Veneto,97,407,1934,2341
ITD3,Veneto,98,253,1328,1581
ITD3,Veneto,99,112,593,705
ITD3,Veneto,100 and over,125,951,1076
ITD3,Veneto,Total,2390898,2493692,4884590
ITD4,Friuli-Venezia Giulia,0,3997,3772,7769
ITD4,Friuli-Venezia Giulia,1,4165,4012,8177
ITD4,Friuli-Venezia Giulia,2,4404,4172,8576
ITD4,Friuli-Venezia Giulia,3,4418,4259,8677
ITD4,Friuli-Venezia Giulia,4,4786,4427,9213
ITD4,Friuli-Venezia Giulia,5,4851,4564,9415
ITD4,Friuli-Venezia Giulia,6,5010,4806,9816
ITD4,Friuli-Venezia Giulia,7,5227,4759,9986
ITD4,Friuli-Venezia Giulia,8,5341,5077,10418
ITD4,Friuli-Venezia Giulia,9,5375,5159,10534
ITD4,Friuli-Venezia Giulia,10,5441,5062,10503
ITD4,Friuli-Venezia Giulia,11,5448,5266,10714
ITD4,Friuli-Venezia Giulia,12,5424,5246,10670
ITD4,Friuli-Venezia Giulia,13,5435,5031,10466
ITD4,Friuli-Venezia Giulia,14,5340,5199,10539
ITD4,Friuli-Venezia Giulia,15,5465,5022,10487
ITD4,Friuli-Venezia Giulia,16,5329,5013,10342
ITD4,Friuli-Venezia Giulia,17,5474,5002,10476
ITD4,Friuli-Venezia Giulia,18,5588,5233,10821
ITD4,Friuli-Venezia Giulia,19,5508,4991,10499
ITD4,Friuli-Venezia Giulia,20,5584,5025,10609
ITD4,Friuli-Venezia Giulia,21,5518,4928,10446
ITD4,Friuli-Venezia Giulia,22,5727,5050,10777
ITD4,Friuli-Venezia Giulia,23,5522,4956,10478
ITD4,Friuli-Venezia Giulia,24,5530,4990,10520
ITD4,Friuli-Venezia Giulia,25,5616,5057,10673
ITD4,Friuli-Venezia Giulia,26,5919,5445,11364
ITD4,Friuli-Venezia Giulia,27,5865,5600,11465
ITD4,Friuli-Venezia Giulia,28,5978,5618,11596
ITD4,Friuli-Venezia Giulia,29,6005,5677,11682
ITD4,Friuli-Venezia Giulia,30,6096,5868,11964
ITD4,Friuli-Venezia Giulia,31,5762,5696,11458
ITD4,Friuli-Venezia Giulia,32,6049,5805,11854
ITD4,Friuli-Venezia Giulia,33,6253,6122,12375
ITD4,Friuli-Venezia Giulia,34,6480,6118,12598
ITD4,Friuli-Venezia Giulia,35,6492,6110,12602
ITD4,Friuli-Venezia Giulia,36,6851,6531,13382
ITD4,Friuli-Venezia Giulia,37,6966,6562,13528
ITD4,Friuli-Venezia Giulia,38,7156,6803,13959
ITD4,Friuli-Venezia Giulia,39,7429,6977,14406
ITD4,Friuli-Venezia Giulia,40,8051,7606,15657
ITD4,Friuli-Venezia Giulia,41,8090,7803,15893
ITD4,Friuli-Venezia Giulia,42,8436,8429,16865
ITD4,Friuli-Venezia Giulia,43,9024,8839,17863
ITD4,Friuli-Venezia Giulia,44,9746,9563,19309
ITD4,Friuli-Venezia Giulia,45,9525,9598,19123
ITD4,Friuli-Venezia Giulia,46,9889,9834,19723
ITD4,Friuli-Venezia Giulia,47,9891,9907,19798
ITD4,Friuli-Venezia Giulia,48,9872,10089,19961
ITD4,Friuli-Venezia Giulia,49,10139,9980,20119
ITD4,Friuli-Venezia Giulia,50,10103,9896,19999
ITD4,Friuli-Venezia Giulia,51,10044,10211,20255
ITD4,Friuli-Venezia Giulia,52,10085,10223,20308
ITD4,Friuli-Venezia Giulia,53,10264,10259,20523
ITD4,Friuli-Venezia Giulia,54,10454,10450,20904
ITD4,Friuli-Venezia Giulia,55,9752,10051,19803
ITD4,Friuli-Venezia Giulia,56,9287,9414,18701
ITD4,Friuli-Venezia Giulia,57,9122,9101,18223
ITD4,Friuli-Venezia Giulia,58,8840,8799,17639
ITD4,Friuli-Venezia Giulia,59,8594,8821,17415
ITD4,Friuli-Venezia Giulia,60,7955,8453,16408
ITD4,Friuli-Venezia Giulia,61,7715,8320,16035
ITD4,Friuli-Venezia Giulia,62,7754,8101,15855
ITD4,Friuli-Venezia Giulia,63,7525,7932,15457
ITD4,Friuli-Venezia Giulia,64,7301,7923,15224
ITD4,Friuli-Venezia Giulia,65,7205,7911,15116
ITD4,Friuli-Venezia Giulia,66,6992,7932,14924
ITD4,Friuli-Venezia Giulia,67,6930,7794,14724
ITD4,Friuli-Venezia Giulia,68,7394,8262,15656
ITD4,Friuli-Venezia Giulia,69,7296,8097,15393
ITD4,Friuli-Venezia Giulia,70,7775,8575,16350
ITD4,Friuli-Venezia Giulia,71,7546,8709,16255
ITD4,Friuli-Venezia Giulia,72,8021,8992,17013
ITD4,Friuli-Venezia Giulia,73,5429,6106,11535
ITD4,Friuli-Venezia Giulia,74,6283,7397,13680
ITD4,Friuli-Venezia Giulia,75,6157,7184,13341
ITD4,Friuli-Venezia Giulia,76,5953,7336,13289
ITD4,Friuli-Venezia Giulia,77,5980,7323,13303
ITD4,Friuli-Venezia Giulia,78,6169,7651,13820
ITD4,Friuli-Venezia Giulia,79,5636,7257,12893
ITD4,Friuli-Venezia Giulia,80,5187,6881,12068
ITD4,Friuli-Venezia Giulia,81,4614,6186,10800
ITD4,Friuli-Venezia Giulia,82,3882,5729,9611
ITD4,Friuli-Venezia Giulia,83,3629,5454,9083
ITD4,Friuli-Venezia Giulia,84,3006,5003,8009
ITD4,Friuli-Venezia Giulia,85,2723,4598,7321
ITD4,Friuli-Venezia Giulia,86,2384,4364,6748
ITD4,Friuli-Venezia Giulia,87,2066,3967,6033
ITD4,Friuli-Venezia Giulia,88,1892,3965,5857
ITD4,Friuli-Venezia Giulia,89,1444,3309,4753
ITD4,Friuli-Venezia Giulia,90,1216,2908,4124
ITD4,Friuli-Venezia Giulia,91,952,2575,3527
ITD4,Friuli-Venezia Giulia,92,729,2287,3016
ITD4,Friuli-Venezia Giulia,93,568,1884,2452
ITD4,Friuli-Venezia Giulia,94,446,1537,1983
ITD4,Friuli-Venezia Giulia,95,325,1182,1507
ITD4,Friuli-Venezia Giulia,96,218,928,1146
ITD4,Friuli-Venezia Giulia,97,154,777,931
ITD4,Friuli-Venezia Giulia,98,99,524,623
ITD4,Friuli-Venezia Giulia,99,44,229,273
ITD4,Friuli-Venezia Giulia,100 and over,37,326,363
ITD4,Friuli-Venezia Giulia,Total,588663,621751,1210414
ITD5,Emilia-Romagna,0,16773,15545,32318
ITD5,Emilia-Romagna,1,17299,16142,33441
ITD5,Emilia-Romagna,2,18003,17135,35138
ITD5,Emilia-Romagna,3,18635,17704,36339
ITD5,Emilia-Romagna,4,19172,18178,37350
ITD5,Emilia-Romagna,5,19557,18719,38276
ITD5,Emilia-Romagna,6,20468,19078,39546
ITD5,Emilia-Romagna,7,20665,19648,40313
ITD5,Emilia-Romagna,8,21555,20120,41675
ITD5,Emilia-Romagna,9,21762,20600,42362
ITD5,Emilia-Romagna,10,21704,20349,42053
ITD5,Emilia-Romagna,11,21687,20154,41841
ITD5,Emilia-Romagna,12,21391,20065,41456
ITD5,Emilia-Romagna,13,20959,19759,40718
ITD5,Emilia-Romagna,14,20727,19582,40309
ITD5,Emilia-Romagna,15,20384,18952,39336
ITD5,Emilia-Romagna,16,20470,19043,39513
ITD5,Emilia-Romagna,17,20410,19008,39418
ITD5,Emilia-Romagna,18,21131,19066,40197
ITD5,Emilia-Romagna,19,20743,18785,39528
ITD5,Emilia-Romagna,20,21564,18363,39927
ITD5,Emilia-Romagna,21,21119,18805,39924
ITD5,Emilia-Romagna,22,20793,18889,39682
ITD5,Emilia-Romagna,23,20745,18669,39414
ITD5,Emilia-Romagna,24,20891,19213,40104
ITD5,Emilia-Romagna,25,21122,19534,40656
ITD5,Emilia-Romagna,26,22072,20752,42824
ITD5,Emilia-Romagna,27,22351,21204,43555
ITD5,Emilia-Romagna,28,22927,22017,44944
ITD5,Emilia-Romagna,29,22713,22209,44922
ITD5,Emilia-Romagna,30,23325,22553,45878
ITD5,Emilia-Romagna,31,23078,22962,46040
ITD5,Emilia-Romagna,32,23197,23416,46613
ITD5,Emilia-Romagna,33,24304,24379,48683
ITD5,Emilia-Romagna,34,24975,24964,49939
ITD5,Emilia-Romagna,35,25516,25619,51135
ITD5,Emilia-Romagna,36,26318,26432,52750
ITD5,Emilia-Romagna,37,26713,26662,53375
ITD5,Emilia-Romagna,38,27846,27648,55494
ITD5,Emilia-Romagna,39,28658,29035,57693
ITD5,Emilia-Romagna,40,30723,30754,61477
ITD5,Emilia-Romagna,41,32036,32170,64206
ITD5,Emilia-Romagna,42,33667,33723,67390
ITD5,Emilia-Romagna,43,35316,35519,70835
ITD5,Emilia-Romagna,44,37199,36788,73987
ITD5,Emilia-Romagna,45,37011,37014,74025
ITD5,Emilia-Romagna,46,37218,37022,74240
ITD5,Emilia-Romagna,47,37405,37317,74722
ITD5,Emilia-Romagna,48,36708,36991,73699
ITD5,Emilia-Romagna,49,37072,37375,74447
ITD5,Emilia-Romagna,50,36998,37062,74060
ITD5,Emilia-Romagna,51,36404,36519,72923
ITD5,Emilia-Romagna,52,36730,36847,73577
ITD5,Emilia-Romagna,53,36050,36509,72559
ITD5,Emilia-Romagna,54,36556,37258,73814
ITD5,Emilia-Romagna,55,34018,34910,68928
ITD5,Emilia-Romagna,56,32538,34053,66591
ITD5,Emilia-Romagna,57,31730,33412,65142
ITD5,Emilia-Romagna,58,30546,32503,63049
ITD5,Emilia-Romagna,59,29807,31791,61598
ITD5,Emilia-Romagna,60,28298,30316,58614
ITD5,Emilia-Romagna,61,28024,30220,58244
ITD5,Emilia-Romagna,62,27478,29724,57202
ITD5,Emilia-Romagna,63,26238,28559,54797
ITD5,Emilia-Romagna,64,25148,28053,53201
ITD5,Emilia-Romagna,65,24108,26741,50849
ITD5,Emilia-Romagna,66,23408,26656,50064
ITD5,Emilia-Romagna,67,23251,26081,49332
ITD5,Emilia-Romagna,68,24087,27444,51531
ITD5,Emilia-Romagna,69,24388,27535,51923
ITD5,Emilia-Romagna,70,25664,29058,54722
ITD5,Emilia-Romagna,71,25701,28453,54154
ITD5,Emilia-Romagna,72,25567,29094,54661
ITD5,Emilia-Romagna,73,17734,20691,38425
ITD5,Emilia-Romagna,74,19720,22897,42617
ITD5,Emilia-Romagna,75,19338,22640,41978
ITD5,Emilia-Romagna,76,18591,22256,40847
ITD5,Emilia-Romagna,77,18767,22604,41371
ITD5,Emilia-Romagna,78,19632,24891,44523
ITD5,Emilia-Romagna,79,18924,24228,43152
ITD5,Emilia-Romagna,80,18276,23840,42116
ITD5,Emilia-Romagna,81,16063,21068,37131
ITD5,Emilia-Romagna,82,13804,19228,33032
ITD5,Emilia-Romagna,83,13956,19584,33540
ITD5,Emilia-Romagna,84,12596,18650,31246
ITD5,Emilia-Romagna,85,10914,16748,27662
ITD5,Emilia-Romagna,86,9371,15184,24555
ITD5,Emilia-Romagna,87,8454,14408,22862
ITD5,Emilia-Romagna,88,7482,13884,21366
ITD5,Emilia-Romagna,89,5995,11555,17550
ITD5,Emilia-Romagna,90,4896,10330,15226
ITD5,Emilia-Romagna,91,3894,9090,12984
ITD5,Emilia-Romagna,92,2936,7522,10458
ITD5,Emilia-Romagna,93,2287,6463,8750
ITD5,Emilia-Romagna,94,1736,5001,6737
ITD5,Emilia-Romagna,95,1250,4064,5314
ITD5,Emilia-Romagna,96,848,2991,3839
ITD5,Emilia-Romagna,97,620,2247,2867
ITD5,Emilia-Romagna,98,382,1471,1853
ITD5,Emilia-Romagna,99,187,746,933
ITD5,Emilia-Romagna,100 and over,180,1097,1277
ITD5,Emilia-Romagna,Total,2169647,2289806,4459453
ITDA,Trentino Alto Adige / Südtirol,0,4949,4690,9639
ITDA,Trentino Alto Adige / Südtirol,1,5125,4836,9961
ITDA,Trentino Alto Adige / Südtirol,2,5234,5006,10240
ITDA,Trentino Alto Adige / Südtirol,3,5295,5006,10301
ITDA,Trentino Alto Adige / Südtirol,4,5453,5133,10586
ITDA,Trentino Alto Adige / Südtirol,5,5466,5128,10594
ITDA,Trentino Alto Adige / Südtirol,6,5571,5232,10803
ITDA,Trentino Alto Adige / Südtirol,7,5553,5308,10861
ITDA,Trentino Alto Adige / Südtirol,8,5711,5315,11026
ITDA,Trentino Alto Adige / Südtirol,9,5631,5284,10915
ITDA,Trentino Alto Adige / Südtirol,10,5746,5466,11212
ITDA,Trentino Alto Adige / Südtirol,11,5781,5323,11104
ITDA,Trentino Alto Adige / Südtirol,12,5757,5425,11182
ITDA,Trentino Alto Adige / Südtirol,13,5926,5399,11325
ITDA,Trentino Alto Adige / Südtirol,14,5910,5568,11478
ITDA,Trentino Alto Adige / Südtirol,15,5819,5375,11194
ITDA,Trentino Alto Adige / Südtirol,16,5723,5353,11076
ITDA,Trentino Alto Adige / Südtirol,17,5959,5425,11384
ITDA,Trentino Alto Adige / Südtirol,18,6003,5670,11673
ITDA,Trentino Alto Adige / Südtirol,19,6069,5659,11728
ITDA,Trentino Alto Adige / Südtirol,20,6108,5743,11851
ITDA,Trentino Alto Adige / Südtirol,21,6202,5615,11817
ITDA,Trentino Alto Adige / Südtirol,22,6098,5683,11781
ITDA,Trentino Alto Adige / Südtirol,23,6033,5487,11520
ITDA,Trentino Alto Adige / Südtirol,24,6023,5693,11716
ITDA,Trentino Alto Adige / Südtirol,25,5909,5686,11595
ITDA,Trentino Alto Adige / Südtirol,26,6193,5830,12023
ITDA,Trentino Alto Adige / Südtirol,27,6180,5785,11965
ITDA,Trentino Alto Adige / Südtirol,28,6220,5857,12077
ITDA,Trentino Alto Adige / Südtirol,29,6052,5886,11938
ITDA,Trentino Alto Adige / Südtirol,30,6107,5863,11970
ITDA,Trentino Alto Adige / Südtirol,31,5947,5848,11795
ITDA,Trentino Alto Adige / Südtirol,32,6024,5831,11855
ITDA,Trentino Alto Adige / Südtirol,33,6175,5990,12165
ITDA,Trentino Alto Adige / Südtirol,34,6237,5994,12231
ITDA,Trentino Alto Adige / Südtirol,35,6354,6215,12569
ITDA,Trentino Alto Adige / Südtirol,36,6542,6451,12993
ITDA,Trentino Alto Adige / Südtirol,37,6534,6375,12909
ITDA,Trentino Alto Adige / Südtirol,38,6597,6475,13072
ITDA,Trentino Alto Adige / Südtirol,39,6510,6619,13129
ITDA,Trentino Alto Adige / Südtirol,40,6948,6912,13860
ITDA,Trentino Alto Adige / Südtirol,41,6997,6954,13951
ITDA,Trentino Alto Adige / Südtirol,42,7118,7370,14488
ITDA,Trentino Alto Adige / Südtirol,43,7534,7739,15273
ITDA,Trentino Alto Adige / Südtirol,44,8130,8059,16189
ITDA,Trentino Alto Adige / Südtirol,45,8022,8208,16230
ITDA,Trentino Alto Adige / Südtirol,46,8204,8255,16459
ITDA,Trentino Alto Adige / Südtirol,47,8522,8536,17058
ITDA,Trentino Alto Adige / Südtirol,48,8340,8388,16728
ITDA,Trentino Alto Adige / Südtirol,49,8987,8607,17594
ITDA,Trentino Alto Adige / Südtirol,50,8835,8641,17476
ITDA,Trentino Alto Adige / Südtirol,51,8633,8774,17407
ITDA,Trentino Alto Adige / Südtirol,52,8886,8848,17734
ITDA,Trentino Alto Adige / Südtirol,53,9145,8784,17929
ITDA,Trentino Alto Adige / Südtirol,54,8995,8830,17825
ITDA,Trentino Alto Adige / Südtirol,55,8432,8278,16710
ITDA,Trentino Alto Adige / Südtirol,56,7846,7957,15803
ITDA,Trentino Alto Adige / Südtirol,57,7767,8009,15776
ITDA,Trentino Alto Adige / Südtirol,58,7580,7513,15093
ITDA,Trentino Alto Adige / Südtirol,59,7328,7241,14569
ITDA,Trentino Alto Adige / Südtirol,60,6787,6886,13673
ITDA,Trentino Alto Adige / Südtirol,61,6490,6901,13391
ITDA,Trentino Alto Adige / Südtirol,62,6443,6541,12984
ITDA,Trentino Alto Adige / Südtirol,63,6123,6254,12377
ITDA,Trentino Alto Adige / Südtirol,64,5869,6074,11943
ITDA,Trentino Alto Adige / Südtirol,65,5724,6029,11753
ITDA,Trentino Alto Adige / Südtirol,66,5545,5887,11432
ITDA,Trentino Alto Adige / Südtirol,67,5491,5638,11129
ITDA,Trentino Alto Adige / Südtirol,68,5509,5923,11432
ITDA,Trentino Alto Adige / Südtirol,69,5335,5601,10936
ITDA,Trentino Alto Adige / Südtirol,70,5493,5780,11273
ITDA,Trentino Alto Adige / Südtirol,71,5132,5754,10886
ITDA,Trentino Alto Adige / Südtirol,72,5457,6167,11624
ITDA,Trentino Alto Adige / Südtirol,73,3902,4344,8246
ITDA,Trentino Alto Adige / Südtirol,74,4370,5045,9415
ITDA,Trentino Alto Adige / Südtirol,75,4580,5296,9876
ITDA,Trentino Alto Adige / Südtirol,76,4438,5242,9680
ITDA,Trentino Alto Adige / Südtirol,77,4336,5236,9572
ITDA,Trentino Alto Adige / Südtirol,78,4017,5051,9068
ITDA,Trentino Alto Adige / Südtirol,79,3794,4802,8596
ITDA,Trentino Alto Adige / Südtirol,80,3472,4493,7965
ITDA,Trentino Alto Adige / Südtirol,81,3044,4009,7053
ITDA,Trentino Alto Adige / Südtirol,82,2637,3814,6451
ITDA,Trentino Alto Adige / Südtirol,83,2445,3704,6149
ITDA,Trentino Alto Adige / Südtirol,84,2251,3519,5770
ITDA,Trentino Alto Adige / Südtirol,85,2084,3276,5360
ITDA,Trentino Alto Adige / Südtirol,86,1827,3065,4892
ITDA,Trentino Alto Adige / Südtirol,87,1620,2825,4445
ITDA,Trentino Alto Adige / Südtirol,88,1424,2781,4205
ITDA,Trentino Alto Adige / Südtirol,89,1073,2314,3387
ITDA,Trentino Alto Adige / Südtirol,90,945,2042,2987
ITDA,Trentino Alto Adige / Südtirol,91,729,1739,2468
ITDA,Trentino Alto Adige / Südtirol,92,547,1452,1999
ITDA,Trentino Alto Adige / Südtirol,93,430,1221,1651
ITDA,Trentino Alto Adige / Südtirol,94,298,1009,1307
ITDA,Trentino Alto Adige / Südtirol,95,250,879,1129
ITDA,Trentino Alto Adige / Südtirol,96,170,679,849
ITDA,Trentino Alto Adige / Südtirol,97,106,446,552
ITDA,Trentino Alto Adige / Südtirol,98,63,305,368
ITDA,Trentino Alto Adige / Südtirol,99,29,139,168
ITDA,Trentino Alto Adige / Südtirol,100 and over,25,163,188
ITDA,Trentino Alto Adige / Südtirol,Total,529279,544755,1074034
ITE1,Toscana,0,12409,12016,24425
ITE1,Toscana,1,13380,12598,25978
ITE1,Toscana,2,13811,13148,26959
ITE1,Toscana,3,14244,13211,27455
ITE1,Toscana,4,14897,14113,29010
ITE1,Toscana,5,15150,14237,29387
ITE1,Toscana,6,15919,15274,31193
ITE1,Toscana,7,16196,15384,31580
ITE1,Toscana,8,16744,15826,32570
ITE1,Toscana,9,16854,15907,32761
ITE1,Toscana,10,17550,16224,33774
ITE1,Toscana,11,17364,16091,33455
ITE1,Toscana,12,17088,16054,33142
ITE1,Toscana,13,17032,15940,32972
ITE1,Toscana,14,17040,15914,32954
ITE1,Toscana,15,16656,15531,32187
ITE1,Toscana,16,16752,15621,32373
ITE1,Toscana,17,16632,15640,32272
ITE1,Toscana,18,17101,15706,32807
ITE1,Toscana,19,17112,15148,32260
ITE1,Toscana,20,17721,15370,33091
ITE1,Toscana,21,17437,15437,32874
ITE1,Toscana,22,17246,15543,32789
ITE1,Toscana,23,17005,15461,32466
ITE1,Toscana,24,16921,15810,32731
ITE1,Toscana,25,17309,15958,33267
ITE1,Toscana,26,18005,17121,35126
ITE1,Toscana,27,18026,17159,35185
ITE1,Toscana,28,18960,17880,36840
ITE1,Toscana,29,18506,18024,36530
ITE1,Toscana,30,19277,18833,38110
ITE1,Toscana,31,18784,18563,37347
ITE1,Toscana,32,18453,18938,37391
ITE1,Toscana,33,19441,19849,39290
ITE1,Toscana,34,19842,19996,39838
ITE1,Toscana,35,20369,20685,41054
ITE1,Toscana,36,21145,21181,42326
ITE1,Toscana,37,21348,21611,42959
ITE1,Toscana,38,22146,22156,44302
ITE1,Toscana,39,23038,23374,46412
ITE1,Toscana,40,24451,24917,49368
ITE1,Toscana,41,25350,25829,51179
ITE1,Toscana,42,26432,27265,53697
ITE1,Toscana,43,27758,28660,56418
ITE1,Toscana,44,29155,30044,59199
ITE1,Toscana,45,29303,30327,59630
ITE1,Toscana,46,29760,30322,60082
ITE1,Toscana,47,29845,30743,60588
ITE1,Toscana,48,29662,29815,59477
ITE1,Toscana,49,30152,30985,61137
ITE1,Toscana,50,29530,30771,60301
ITE1,Toscana,51,29577,31055,60632
ITE1,Toscana,52,30270,31147,61417
ITE1,Toscana,53,30193,31242,61435
ITE1,Toscana,54,30325,31635,61960
ITE1,Toscana,55,28250,29634,57884
ITE1,Toscana,56,27169,28617,55786
ITE1,Toscana,57,26336,28287,54623
ITE1,Toscana,58,25768,27198,52966
ITE1,Toscana,59,25126,26519,51645
ITE1,Toscana,60,23656,25987,49643
ITE1,Toscana,61,23201,25348,48549
ITE1,Toscana,62,22835,24997,47832
ITE1,Toscana,63,22199,24636,46835
ITE1,Toscana,64,21826,24453,46279
ITE1,Toscana,65,20988,22902,43890
ITE1,Toscana,66,20609,22921,43530
ITE1,Toscana,67,20621,22566,43187
ITE1,Toscana,68,21118,23325,44443
ITE1,Toscana,69,21820,24522,46342
ITE1,Toscana,70,23142,26038,49180
ITE1,Toscana,71,22799,26109,48908
ITE1,Toscana,72,22801,26137,48938
ITE1,Toscana,73,17462,20311,37773
ITE1,Toscana,74,17237,20219,37456
ITE1,Toscana,75,17030,20290,37320
ITE1,Toscana,76,15969,19422,35391
ITE1,Toscana,77,16032,20112,36144
ITE1,Toscana,78,17450,22478,39928
ITE1,Toscana,79,16691,21298,37989
ITE1,Toscana,80,16289,21141,37430
ITE1,Toscana,81,13973,19030,33003
ITE1,Toscana,82,12228,17026,29254
ITE1,Toscana,83,11938,17020,28958
ITE1,Toscana,84,10367,15404,25771
ITE1,Toscana,85,9281,14408,23689
ITE1,Toscana,86,8017,13319,21336
ITE1,Toscana,87,7285,12725,20010
ITE1,Toscana,88,6493,12198,18691
ITE1,Toscana,89,5086,10200,15286
ITE1,Toscana,90,4154,9120,13274
ITE1,Toscana,91,3380,7750,11130
ITE1,Toscana,92,2620,6363,8983
ITE1,Toscana,93,1878,5319,7197
ITE1,Toscana,94,1439,4263,5702
ITE1,Toscana,95,1039,3333,4372
ITE1,Toscana,96,675,2455,3130
ITE1,Toscana,97,496,1855,2351
ITE1,Toscana,98,289,1348,1637
ITE1,Toscana,99,132,594,726
ITE1,Toscana,100 and over,164,826,990
ITE1,Toscana,Total,1788031,1913312,3701343
ITE2,Umbria,0,2945,2745,5690
ITE2,Umbria,1,3075,2917,5992
ITE2,Umbria,2,3257,3095,6352
ITE2,Umbria,3,3297,3144,6441
ITE2,Umbria,4,3489,3350,6839
ITE2,Umbria,5,3687,3435,7122
ITE2,Umbria,6,3753,3719,7472
ITE2,Umbria,7,3844,3704,7548
ITE2,Umbria,8,3986,3736,7722
ITE2,Umbria,9,4010,3713,7723
ITE2,Umbria,10,4132,4006,8138
ITE2,Umbria,11,4192,3912,8104
ITE2,Umbria,12,4123,3831,7954
ITE2,Umbria,13,4111,3821,7932
ITE2,Umbria,14,3941,3790,7731
ITE2,Umbria,15,3997,3625,7622
ITE2,Umbria,16,3889,3755,7644
ITE2,Umbria,17,3900,3644,7544
ITE2,Umbria,18,3964,3803,7767
ITE2,Umbria,19,4188,3582,7770
ITE2,Umbria,20,4237,3643,7880
ITE2,Umbria,21,4144,3684,7828
ITE2,Umbria,22,4146,3731,7877
ITE2,Umbria,23,4126,3774,7900
ITE2,Umbria,24,4092,3815,7907
ITE2,Umbria,25,4216,3921,8137
ITE2,Umbria,26,4459,4133,8592
ITE2,Umbria,27,4363,4073,8436
ITE2,Umbria,28,4475,4229,8704
ITE2,Umbria,29,4551,4359,8910
ITE2,Umbria,30,4682,4635,9317
ITE2,Umbria,31,4558,4474,9032
ITE2,Umbria,32,4574,4647,9221
ITE2,Umbria,33,4664,4824,9488
ITE2,Umbria,34,4718,4877,9595
ITE2,Umbria,35,5146,5169,10315
ITE2,Umbria,36,5140,5071,10211
ITE2,Umbria,37,5230,5268,10498
ITE2,Umbria,38,5298,5289,10587
ITE2,Umbria,39,5494,5522,11016
ITE2,Umbria,40,5644,5920,11564
ITE2,Umbria,41,5982,6078,12060
ITE2,Umbria,42,6200,6253,12453
ITE2,Umbria,43,6372,6699,13071
ITE2,Umbria,44,6649,7006,13655
ITE2,Umbria,45,6681,6888,13569
ITE2,Umbria,46,6524,6916,13440
ITE2,Umbria,47,6667,6983,13650
ITE2,Umbria,48,6669,6782,13451
ITE2,Umbria,49,6729,7103,13832
ITE2,Umbria,50,6677,7168,13845
ITE2,Umbria,51,6577,7111,13688
ITE2,Umbria,52,6694,7016,13710
ITE2,Umbria,53,6927,7261,14188
ITE2,Umbria,54,6948,7291,14239
ITE2,Umbria,55,6360,6991,13351
ITE2,Umbria,56,6245,6744,12989
ITE2,Umbria,57,6294,6625,12919
ITE2,Umbria,58,6129,6630,12759
ITE2,Umbria,59,5867,6369,12236
ITE2,Umbria,60,5549,6000,11549
ITE2,Umbria,61,5410,5907,11317
ITE2,Umbria,62,5508,5981,11489
ITE2,Umbria,63,5372,5851,11223
ITE2,Umbria,64,5164,5771,10935
ITE2,Umbria,65,5150,5603,10753
ITE2,Umbria,66,4798,5342,10140
ITE2,Umbria,67,5045,5568,10613
ITE2,Umbria,68,5138,5599,10737
ITE2,Umbria,69,5301,5804,11105
ITE2,Umbria,70,5645,6170,11815
ITE2,Umbria,71,5202,5704,10906
ITE2,Umbria,72,4875,5550,10425
ITE2,Umbria,73,3863,4468,8331
ITE2,Umbria,74,3988,4796,8784
ITE2,Umbria,75,4248,4885,9133
ITE2,Umbria,76,3867,4503,8370
ITE2,Umbria,77,3832,4562,8394
ITE2,Umbria,78,4196,5034,9230
ITE2,Umbria,79,3894,5036,8930
ITE2,Umbria,80,3920,4994,8914
ITE2,Umbria,81,3235,4542,7777
ITE2,Umbria,82,2853,4097,6950
ITE2,Umbria,83,2831,4046,6877
ITE2,Umbria,84,2596,3883,6479
ITE2,Umbria,85,2348,3600,5948
ITE2,Umbria,86,2000,3151,5151
ITE2,Umbria,87,1844,3201,5045
ITE2,Umbria,88,1595,3049,4644
ITE2,Umbria,89,1179,2488,3667
ITE2,Umbria,90,1004,2198,3202
ITE2,Umbria,91,821,2005,2826
ITE2,Umbria,92,667,1604,2271
ITE2,Umbria,93,530,1373,1903
ITE2,Umbria,94,388,1079,1467
ITE2,Umbria,95,246,808,1054
ITE2,Umbria,96,166,591,757
ITE2,Umbria,97,125,453,578
ITE2,Umbria,98,72,310,382
ITE2,Umbria,99,27,158,185
ITE2,Umbria,100 and over,31,230,261
ITE2,Umbria,Total,421451,452293,873744
ITE3,Marche,0,5205,4871,10076
ITE3,Marche,1,5454,5187,10641
ITE3,Marche,2,5906,5491,11397
ITE3,Marche,3,6010,5838,11848
ITE3,Marche,4,6253,5937,12190
ITE3,Marche,5,6530,5970,12500
ITE3,Marche,6,6627,6236,12863
ITE3,Marche,7,6823,6638,13461
ITE3,Marche,8,7062,6612,13674
ITE3,Marche,9,7239,6788,14027
ITE3,Marche,10,7269,6824,14093
ITE3,Marche,11,7164,6727,13891
ITE3,Marche,12,7062,6657,13719
ITE3,Marche,13,7002,6664,13666
ITE3,Marche,14,7113,6566,13679
ITE3,Marche,15,6933,6582,13515
ITE3,Marche,16,7086,6558,13644
ITE3,Marche,17,6997,6557,13554
ITE3,Marche,18,7504,6675,14179
ITE3,Marche,19,7422,6744,14166
ITE3,Marche,20,7765,6762,14527
ITE3,Marche,21,7548,6789,14337
ITE3,Marche,22,7488,6716,14204
ITE3,Marche,23,7533,6840,14373
ITE3,Marche,24,7429,6860,14289
ITE3,Marche,25,7534,7113,14647
ITE3,Marche,26,7863,7378,15241
ITE3,Marche,27,7950,7351,15301
ITE3,Marche,28,7960,7608,15568
ITE3,Marche,29,7802,7583,15385
ITE3,Marche,30,7908,7886,15794
ITE3,Marche,31,7806,7581,15387
ITE3,Marche,32,8131,7865,15996
ITE3,Marche,33,8117,8233,16350
ITE3,Marche,34,8266,8223,16489
ITE3,Marche,35,8472,8577,17049
ITE3,Marche,36,8895,8876,17771
ITE3,Marche,37,8994,8895,17889
ITE3,Marche,38,9351,9253,18604
ITE3,Marche,39,9669,9824,19493
ITE3,Marche,40,10427,10336,20763
ITE3,Marche,41,10559,10770,21329
ITE3,Marche,42,11018,10881,21899
ITE3,Marche,43,11441,11621,23062
ITE3,Marche,44,11864,11751,23615
ITE3,Marche,45,11556,11722,23278
ITE3,Marche,46,11763,11775,23538
ITE3,Marche,47,12000,12293,24293
ITE3,Marche,48,11736,11836,23572
ITE3,Marche,49,11927,12515,24442
ITE3,Marche,50,11967,12193,24160
ITE3,Marche,51,11866,12298,24164
ITE3,Marche,52,12015,12341,24356
ITE3,Marche,53,12027,12165,24192
ITE3,Marche,54,12324,12572,24896
ITE3,Marche,55,11563,12058,23621
ITE3,Marche,56,11193,11231,22424
ITE3,Marche,57,11205,11506,22711
ITE3,Marche,58,10638,11213,21851
ITE3,Marche,59,10220,11030,21250
ITE3,Marche,60,9979,10661,20640
ITE3,Marche,61,9712,10458,20170
ITE3,Marche,62,9647,10643,20290
ITE3,Marche,63,9296,10220,19516
ITE3,Marche,64,9056,9736,18792
ITE3,Marche,65,8732,9522,18254
ITE3,Marche,66,8799,9363,18162
ITE3,Marche,67,8793,9623,18416
ITE3,Marche,68,8985,9697,18682
ITE3,Marche,69,8583,9406,17989
ITE3,Marche,70,8784,9737,18521
ITE3,Marche,71,8514,9306,17820
ITE3,Marche,72,8350,9478,17828
ITE3,Marche,73,6906,7730,14636
ITE3,Marche,74,6529,7588,14117
ITE3,Marche,75,6818,7897,14715
ITE3,Marche,76,6305,7527,13832
ITE3,Marche,77,6096,7605,13701
ITE3,Marche,78,6821,8634,15455
ITE3,Marche,79,6866,8663,15529
ITE3,Marche,80,6639,8700,15339
ITE3,Marche,81,5809,7602,13411
ITE3,Marche,82,4966,7109,12075
ITE3,Marche,83,4951,7195,12146
ITE3,Marche,84,4501,6574,11075
ITE3,Marche,85,3889,6156,10045
ITE3,Marche,86,3299,5378,8677
ITE3,Marche,87,3129,5393,8522
ITE3,Marche,88,2719,4969,7688
ITE3,Marche,89,2125,4034,6159
ITE3,Marche,90,1787,3719,5506
ITE3,Marche,91,1472,3370,4842
ITE3,Marche,92,1111,2832,3943
ITE3,Marche,93,881,2320,3201
ITE3,Marche,94,570,1739,2309
ITE3,Marche,95,449,1360,1809
ITE3,Marche,96,300,979,1279
ITE3,Marche,97,206,749,955
ITE3,Marche,98,143,534,677
ITE3,Marche,99,58,220,278
ITE3,Marche,100 and over,62,365,427
ITE3,Marche,Total,739088,781233,1520321
ITE4,Lazio,0,20494,19313,39807
ITE4,Lazio,1,22821,21384,44205
ITE4,Lazio,2,23968,22644,46612
ITE4,Lazio,3,24348,23473,47821
ITE4,Lazio,4,25626,23920,49546
ITE4,Lazio,5,26008,24550,50558
ITE4,Lazio,6,27368,26041,53409
ITE4,Lazio,7,27467,25937,53404
ITE4,Lazio,8,28122,26532,54654
ITE4,Lazio,9,28365,26478,54843
ITE4,Lazio,10,28196,27070,55266
ITE4,Lazio,11,28707,26794,55501
ITE4,Lazio,12,28258,26749,55007
ITE4,Lazio,13,27439,25828,53267
ITE4,Lazio,14,27658,25971,53629
ITE4,Lazio,15,27242,25862,53104
ITE4,Lazio,16,26916,25214,52130
ITE4,Lazio,17,27055,25381,52436
ITE4,Lazio,18,27767,25627,53394
ITE4,Lazio,19,27711,25223,52934
ITE4,Lazio,20,28596,25563,54159
ITE4,Lazio,21,28442,25591,54033
ITE4,Lazio,22,28734,25787,54521
ITE4,Lazio,23,29160,25976,55136
ITE4,Lazio,24,29084,26641,55725
ITE4,Lazio,25,29318,27491,56809
ITE4,Lazio,26,30686,28747,59433
ITE4,Lazio,27,30243,28739,58982
ITE4,Lazio,28,31274,29729,61003
ITE4,Lazio,29,31202,30086,61288
ITE4,Lazio,30,32137,31335,63472
ITE4,Lazio,31,31694,31497,63191
ITE4,Lazio,32,32064,31593,63657
ITE4,Lazio,33,33443,33255,66698
ITE4,Lazio,34,34690,34249,68939
ITE4,Lazio,35,35582,34947,70529
ITE4,Lazio,36,36625,36746,73371
ITE4,Lazio,37,36735,37522,74257
ITE4,Lazio,38,37685,38220,75905
ITE4,Lazio,39,38711,39582,78293
ITE4,Lazio,40,40796,41885,82681
ITE4,Lazio,41,41679,42660,84339
ITE4,Lazio,42,42996,44816,87812
ITE4,Lazio,43,45122,47093,92215
ITE4,Lazio,44,46748,49349,96097
ITE4,Lazio,45,46808,49133,95941
ITE4,Lazio,46,47124,49905,97029
ITE4,Lazio,47,47060,49995,97055
ITE4,Lazio,48,47206,49736,96942
ITE4,Lazio,49,47517,50763,98280
ITE4,Lazio,50,46888,50275,97163
ITE4,Lazio,51,46703,50512,97215
ITE4,Lazio,52,47532,50115,97647
ITE4,Lazio,53,47323,50121,97444
ITE4,Lazio,54,47830,51139,98969
ITE4,Lazio,55,44646,48072,92718
ITE4,Lazio,56,42599,45951,88550
ITE4,Lazio,57,41342,44827,86169
ITE4,Lazio,58,39367,43043,82410
ITE4,Lazio,59,37969,41811,79780
ITE4,Lazio,60,36198,40092,76290
ITE4,Lazio,61,35510,39364,74874
ITE4,Lazio,62,34706,38291,72997
ITE4,Lazio,63,33907,37688,71595
ITE4,Lazio,64,32987,37139,70126
ITE4,Lazio,65,30961,34942,65903
ITE4,Lazio,66,30099,33969,64068
ITE4,Lazio,67,29466,33699,63165
ITE4,Lazio,68,30130,34402,64532
ITE4,Lazio,69,29956,34281,64237
ITE4,Lazio,70,31118,36267,67385
ITE4,Lazio,71,30760,35579,66339
ITE4,Lazio,72,29246,34888,64134
ITE4,Lazio,73,22442,27274,49716
ITE4,Lazio,74,22319,27108,49427
ITE4,Lazio,75,22705,28563,51268
ITE4,Lazio,76,21759,27465,49224
ITE4,Lazio,77,21546,27485,49031
ITE4,Lazio,78,22875,30112,52987
ITE4,Lazio,79,21601,28638,50239
ITE4,Lazio,80,19964,27215,47179
ITE4,Lazio,81,17705,24779,42484
ITE4,Lazio,82,15680,22735,38415
ITE4,Lazio,83,15027,22168,37195
ITE4,Lazio,84,13157,20733,33890
ITE4,Lazio,85,11565,18654,30219
ITE4,Lazio,86,9871,16814,26685
ITE4,Lazio,87,8930,15616,24546
ITE4,Lazio,88,7854,15031,22885
ITE4,Lazio,89,6144,11944,18088
ITE4,Lazio,90,4783,10297,15080
ITE4,Lazio,91,3717,8813,12530
ITE4,Lazio,92,2926,7341,10267
ITE4,Lazio,93,2122,5707,7829
ITE4,Lazio,94,1639,4565,6204
ITE4,Lazio,95,1137,3628,4765
ITE4,Lazio,96,818,2623,3441
ITE4,Lazio,97,541,1979,2520
ITE4,Lazio,98,387,1387,1774
ITE4,Lazio,99,157,619,776
ITE4,Lazio,100 and over,229,1154,1383
ITE4,Lazio,Total,2787540,2985536,5773076
ITF1,Abruzzo,0,4471,4259,8730
ITF1,Abruzzo,1,4864,4562,9426
ITF1,Abruzzo,2,5103,4803,9906
ITF1,Abruzzo,3,5203,4874,10077
ITF1,Abruzzo,4,5274,4987,10261
ITF1,Abruzzo,5,5383,5055,10438
ITF1,Abruzzo,6,5603,5346,10949
ITF1,Abruzzo,7,5796,5307,11103
ITF1,Abruzzo,8,5898,5614,11512
ITF1,Abruzzo,9,5797,5480,11277
ITF1,Abruzzo,10,6010,5679,11689
ITF1,Abruzzo,11,5845,5615,11460
ITF1,Abruzzo,12,5873,5482,11355
ITF1,Abruzzo,13,5871,5628,11499
ITF1,Abruzzo,14,6008,5533,11541
ITF1,Abruzzo,15,5949,5523,11472
ITF1,Abruzzo,16,5895,5441,11336
ITF1,Abruzzo,17,6029,5689,11718
ITF1,Abruzzo,18,6361,5626,11987
ITF1,Abruzzo,19,6340,5725,12065
ITF1,Abruzzo,20,6489,5910,12399
ITF1,Abruzzo,21,6556,5818,12374
ITF1,Abruzzo,22,6519,6084,12603
ITF1,Abruzzo,23,6620,5963,12583
ITF1,Abruzzo,24,6758,6324,13082
ITF1,Abruzzo,25,7056,6489,13545
ITF1,Abruzzo,26,7271,6804,14075
ITF1,Abruzzo,27,7193,6796,13989
ITF1,Abruzzo,28,7319,6953,14272
ITF1,Abruzzo,29,7432,6896,14328
ITF1,Abruzzo,30,7435,7137,14572
ITF1,Abruzzo,31,7188,7063,14251
ITF1,Abruzzo,32,7457,7191,14648
ITF1,Abruzzo,33,7627,7432,15059
ITF1,Abruzzo,34,7799,7493,15292
ITF1,Abruzzo,35,7772,7508,15280
ITF1,Abruzzo,36,8005,7992,15997
ITF1,Abruzzo,37,8007,7886,15893
ITF1,Abruzzo,38,8330,7976,16306
ITF1,Abruzzo,39,8609,8331,16940
ITF1,Abruzzo,40,8975,8643,17618
ITF1,Abruzzo,41,9000,8728,17728
ITF1,Abruzzo,42,9363,9208,18571
ITF1,Abruzzo,43,9380,9637,19017
ITF1,Abruzzo,44,10009,9840,19849
ITF1,Abruzzo,45,9681,9974,19655
ITF1,Abruzzo,46,9972,10218,20190
ITF1,Abruzzo,47,10071,10530,20601
ITF1,Abruzzo,48,9942,10260,20202
ITF1,Abruzzo,49,10440,10622,21062
ITF1,Abruzzo,50,10326,10558,20884
ITF1,Abruzzo,51,10319,10771,21090
ITF1,Abruzzo,52,10464,10790,21254
ITF1,Abruzzo,53,10478,10812,21290
ITF1,Abruzzo,54,10658,10767,21425
ITF1,Abruzzo,55,9887,10289,20176
ITF1,Abruzzo,56,9468,9917,19385
ITF1,Abruzzo,57,9141,9941,19082
ITF1,Abruzzo,58,9067,9734,18801
ITF1,Abruzzo,59,8907,9590,18497
ITF1,Abruzzo,60,8583,9198,17781
ITF1,Abruzzo,61,8465,9067,17532
ITF1,Abruzzo,62,8467,8797,17264
ITF1,Abruzzo,63,8265,8965,17230
ITF1,Abruzzo,64,8099,8765,16864
ITF1,Abruzzo,65,7579,8211,15790
ITF1,Abruzzo,66,7540,8148,15688
ITF1,Abruzzo,67,7399,8286,15685
ITF1,Abruzzo,68,7768,8379,16147
ITF1,Abruzzo,69,7822,8572,16394
ITF1,Abruzzo,70,7825,8735,16560
ITF1,Abruzzo,71,7454,8116,15570
ITF1,Abruzzo,72,7216,7819,15035
ITF1,Abruzzo,73,5223,6002,11225
ITF1,Abruzzo,74,5684,6341,12025
ITF1,Abruzzo,75,5291,6206,11497
ITF1,Abruzzo,76,5076,5983,11059
ITF1,Abruzzo,77,5050,5974,11024
ITF1,Abruzzo,78,5571,6881,12452
ITF1,Abruzzo,79,5445,6870,12315
ITF1,Abruzzo,80,4883,6163,11046
ITF1,Abruzzo,81,4626,6014,10640
ITF1,Abruzzo,82,4107,5615,9722
ITF1,Abruzzo,83,3902,5569,9471
ITF1,Abruzzo,84,3465,5200,8665
ITF1,Abruzzo,85,3227,5083,8310
ITF1,Abruzzo,86,2737,4361,7098
ITF1,Abruzzo,87,2420,4199,6619
ITF1,Abruzzo,88,2234,4082,6316
ITF1,Abruzzo,89,1699,3285,4984
ITF1,Abruzzo,90,1363,2865,4228
ITF1,Abruzzo,91,1118,2564,3682
ITF1,Abruzzo,92,804,2032,2836
ITF1,Abruzzo,93,636,1622,2258
ITF1,Abruzzo,94,481,1292,1773
ITF1,Abruzzo,95,338,997,1335
ITF1,Abruzzo,96,223,777,1000
ITF1,Abruzzo,97,197,557,754
ITF1,Abruzzo,98,107,383,490
ITF1,Abruzzo,99,44,186,230
ITF1,Abruzzo,100 and over,65,320,385
ITF1,Abruzzo,Total,635061,665584,1300645
ITF2,Molise,0,941,913,1854
ITF2,Molise,1,1098,988,2086
ITF2,Molise,2,1037,1007,2044
ITF2,Molise,3,1103,1026,2129
ITF2,Molise,4,1172,997,2169
ITF2,Molise,5,1130,1076,2206
ITF2,Molise,6,1177,1089,2266
ITF2,Molise,7,1163,1148,2311
ITF2,Molise,8,1275,1158,2433
ITF2,Molise,9,1182,1097,2279
ITF2,Molise,10,1308,1171,2479
ITF2,Molise,11,1269,1213,2482
ITF2,Molise,12,1269,1212,2481
ITF2,Molise,13,1343,1219,2562
ITF2,Molise,14,1372,1202,2574
ITF2,Molise,15,1349,1247,2596
ITF2,Molise,16,1348,1314,2662
ITF2,Molise,17,1402,1313,2715
ITF2,Molise,18,1509,1384,2893
ITF2,Molise,19,1624,1383,3007
ITF2,Molise,20,1827,1418,3245
ITF2,Molise,21,1743,1407,3150
ITF2,Molise,22,1662,1494,3156
ITF2,Molise,23,1686,1532,3218
ITF2,Molise,24,1777,1526,3303
ITF2,Molise,25,1789,1602,3391
ITF2,Molise,26,1850,1695,3545
ITF2,Molise,27,1913,1594,3507
ITF2,Molise,28,1804,1654,3458
ITF2,Molise,29,1809,1637,3446
ITF2,Molise,30,1816,1659,3475
ITF2,Molise,31,1871,1645,3516
ITF2,Molise,32,1807,1588,3395
ITF2,Molise,33,1823,1701,3524
ITF2,Molise,34,1819,1680,3499
ITF2,Molise,35,1847,1675,3522
ITF2,Molise,36,1863,1787,3650
ITF2,Molise,37,1891,1801,3692
ITF2,Molise,38,1846,1787,3633
ITF2,Molise,39,1931,1890,3821
ITF2,Molise,40,1971,1927,3898
ITF2,Molise,41,2003,1971,3974
ITF2,Molise,42,2165,1925,4090
ITF2,Molise,43,2217,2140,4357
ITF2,Molise,44,2274,2232,4506
ITF2,Molise,45,2162,2200,4362
ITF2,Molise,46,2224,2253,4477
ITF2,Molise,47,2226,2221,4447
ITF2,Molise,48,2225,2235,4460
ITF2,Molise,49,2307,2386,4693
ITF2,Molise,50,2345,2385,4730
ITF2,Molise,51,2356,2478,4834
ITF2,Molise,52,2381,2507,4888
ITF2,Molise,53,2424,2468,4892
ITF2,Molise,54,2534,2513,5047
ITF2,Molise,55,2377,2322,4699
ITF2,Molise,56,2261,2335,4596
ITF2,Molise,57,2305,2250,4555
ITF2,Molise,58,2291,2352,4643
ITF2,Molise,59,2174,2281,4455
ITF2,Molise,60,2004,2208,4212
ITF2,Molise,61,2081,2133,4214
ITF2,Molise,62,2116,2100,4216
ITF2,Molise,63,2048,2098,4146
ITF2,Molise,64,2011,2164,4175
ITF2,Molise,65,1863,1944,3807
ITF2,Molise,66,1903,2027,3930
ITF2,Molise,67,1767,1865,3632
ITF2,Molise,68,1935,1994,3929
ITF2,Molise,69,1997,2073,4070
ITF2,Molise,70,1929,2011,3940
ITF2,Molise,71,1804,1947,3751
ITF2,Molise,72,1719,1746,3465
ITF2,Molise,73,1276,1406,2682
ITF2,Molise,74,1227,1395,2622
ITF2,Molise,75,1136,1311,2447
ITF2,Molise,76,1101,1253,2354
ITF2,Molise,77,1149,1425,2574
ITF2,Molise,78,1265,1622,2887
ITF2,Molise,79,1287,1721,3008
ITF2,Molise,80,1132,1428,2560
ITF2,Molise,81,1057,1460,2517
ITF2,Molise,82,986,1491,2477
ITF2,Molise,83,934,1422,2356
ITF2,Molise,84,926,1378,2304
ITF2,Molise,85,805,1312,2117
ITF2,Molise,86,657,1138,1795
ITF2,Molise,87,604,1053,1657
ITF2,Molise,88,546,1100,1646
ITF2,Molise,89,448,859,1307
ITF2,Molise,90,321,744,1065
ITF2,Molise,91,285,691,976
ITF2,Molise,92,208,563,771
ITF2,Molise,93,155,417,572
ITF2,Molise,94,126,351,477
ITF2,Molise,95,93,262,355
ITF2,Molise,96,71,215,286
ITF2,Molise,97,55,157,212
ITF2,Molise,98,31,108,139
ITF2,Molise,99,14,45,59
ITF2,Molise,100 and over,22,82,104
ITF2,Molise,Total,149761,154029,303790
ITF3,Campania,0,24388,22735,47123
ITF3,Campania,1,25272,24094,49366
ITF3,Campania,2,25464,24108,49572
ITF3,Campania,3,25768,24455,50223
ITF3,Campania,4,26382,24585,50967
ITF3,Campania,5,26554,25484,52038
ITF3,Campania,6,28138,26265,54403
ITF3,Campania,7,28665,26879,55544
ITF3,Campania,8,29630,27585,57215
ITF3,Campania,9,30110,28726,58836
ITF3,Campania,10,30417,29115,59532
ITF3,Campania,11,31037,29665,60702
ITF3,Campania,12,31565,29518,61083
ITF3,Campania,13,31719,29962,61681
ITF3,Campania,14,32871,30899,63770
ITF3,Campania,15,32955,31567,64522
ITF3,Campania,16,32839,31177,64016
ITF3,Campania,17,33940,31676,65616
ITF3,Campania,18,34759,32413,67172
ITF3,Campania,19,35328,32463,67791
ITF3,Campania,20,35925,32437,68362
ITF3,Campania,21,35710,32548,68258
ITF3,Campania,22,35833,33120,68953
ITF3,Campania,23,35363,33727,69090
ITF3,Campania,24,35999,34007,70006
ITF3,Campania,25,36380,34910,71290
ITF3,Campania,26,37895,36445,74340
ITF3,Campania,27,37141,36201,73342
ITF3,Campania,28,36909,35865,72774
ITF3,Campania,29,36373,35801,72174
ITF3,Campania,30,36598,36252,72850
ITF3,Campania,31,35710,34640,70350
ITF3,Campania,32,35154,34555,69709
ITF3,Campania,33,36182,35005,71187
ITF3,Campania,34,36012,36032,72044
ITF3,Campania,35,36275,36251,72526
ITF3,Campania,36,37437,36845,74282
ITF3,Campania,37,36507,36865,73372
ITF3,Campania,38,37168,37018,74186
ITF3,Campania,39,37711,38136,75847
ITF3,Campania,40,38643,39297,77940
ITF3,Campania,41,39419,40103,79522
ITF3,Campania,42,40810,41669,82479
ITF3,Campania,43,42316,42887,85203
ITF3,Campania,44,43342,44948,88290
ITF3,Campania,45,42420,44466,86886
ITF3,Campania,46,42651,44763,87414
ITF3,Campania,47,42597,45300,87897
ITF3,Campania,48,41895,44630,86525
ITF3,Campania,49,43235,45578,88813
ITF3,Campania,50,43035,45766,88801
ITF3,Campania,51,43385,46398,89783
ITF3,Campania,52,43781,46597,90378
ITF3,Campania,53,43785,46432,90217
ITF3,Campania,54,44587,47499,92086
ITF3,Campania,55,41505,44828,86333
ITF3,Campania,56,40346,44006,84352
ITF3,Campania,57,39455,42970,82425
ITF3,Campania,58,37678,41230,78908
ITF3,Campania,59,37281,40314,77595
ITF3,Campania,60,35224,38355,73579
ITF3,Campania,61,34777,37735,72512
ITF3,Campania,62,32913,36174,69087
ITF3,Campania,63,33628,36141,69769
ITF3,Campania,64,32757,35983,68740
ITF3,Campania,65,30199,32713,62912
ITF3,Campania,66,29155,31641,60796
ITF3,Campania,67,29124,31477,60601
ITF3,Campania,68,29356,32079,61435
ITF3,Campania,69,28946,32148,61094
ITF3,Campania,70,29416,32696,62112
ITF3,Campania,71,27983,31494,59477
ITF3,Campania,72,27907,31590,59497
ITF3,Campania,73,22479,25659,48138
ITF3,Campania,74,18754,22011,40765
ITF3,Campania,75,19508,23998,43506
ITF3,Campania,76,18344,22728,41072
ITF3,Campania,77,16879,21908,38787
ITF3,Campania,78,18124,23685,41809
ITF3,Campania,79,17062,22990,40052
ITF3,Campania,80,15091,21029,36120
ITF3,Campania,81,13756,19579,33335
ITF3,Campania,82,11830,17991,29821
ITF3,Campania,83,11441,17520,28961
ITF3,Campania,84,9843,15926,25769
ITF3,Campania,85,9086,15086,24172
ITF3,Campania,86,7832,13576,21408
ITF3,Campania,87,6661,12246,18907
ITF3,Campania,88,5763,11499,17262
ITF3,Campania,89,4468,9215,13683
ITF3,Campania,90,3492,7898,11390
ITF3,Campania,91,2714,6503,9217
ITF3,Campania,92,2068,5114,7182
ITF3,Campania,93,1463,4196,5659
ITF3,Campania,94,1063,3135,4198
ITF3,Campania,95,757,2369,3126
ITF3,Campania,96,540,1719,2259
ITF3,Campania,97,359,1289,1648
ITF3,Campania,98,256,857,1113
ITF3,Campania,99,103,373,476
ITF3,Campania,100 and over,188,696,884
ITF3,Campania,Total,2799558,2940733,5740291
ITF4,Puglia,0,14683,13600,28283
ITF4,Puglia,1,15103,14520,29623
ITF4,Puglia,2,15732,14836,30568
ITF4,Puglia,3,15831,15143,30974
ITF4,Puglia,4,16717,15601,32318
ITF4,Puglia,5,17002,16058,33060
ITF4,Puglia,6,17690,16575,34265
ITF4,Puglia,7,18198,17177,35375
ITF4,Puglia,8,18747,17767,36514
ITF4,Puglia,9,19058,17916,36974
ITF4,Puglia,10,19302,18168,37470
ITF4,Puglia,11,19564,18350,37914
ITF4,Puglia,12,19516,18628,38144
ITF4,Puglia,13,20069,18781,38850
ITF4,Puglia,14,20467,19761,40228
ITF4,Puglia,15,20737,19853,40590
ITF4,Puglia,16,20811,19957,40768
ITF4,Puglia,17,21634,20296,41930
ITF4,Puglia,18,22221,20896,43117
ITF4,Puglia,19,22713,20546,43259
ITF4,Puglia,20,22780,20659,43439
ITF4,Puglia,21,22657,20721,43378
ITF4,Puglia,22,22643,20975,43618
ITF4,Puglia,23,22643,20961,43604
ITF4,Puglia,24,22789,21229,44018
ITF4,Puglia,25,23380,21902,45282
ITF4,Puglia,26,24301,22894,47195
ITF4,Puglia,27,23759,22415,46174
ITF4,Puglia,28,23625,22258,45883
ITF4,Puglia,29,22810,22475,45285
ITF4,Puglia,30,23606,22729,46335
ITF4,Puglia,31,22924,22319,45243
ITF4,Puglia,32,22786,21964,44750
ITF4,Puglia,33,22390,22293,44683
ITF4,Puglia,34,22982,23231,46213
ITF4,Puglia,35,23302,23165,46467
ITF4,Puglia,36,23756,24201,47957
ITF4,Puglia,37,23947,24666,48613
ITF4,Puglia,38,24943,25124,50067
ITF4,Puglia,39,26236,26419,52655
ITF4,Puglia,40,27143,27274,54417
ITF4,Puglia,41,28285,28401,56686
ITF4,Puglia,42,29133,29656,58789
ITF4,Puglia,43,30009,30350,60359
ITF4,Puglia,44,30381,31582,61963
ITF4,Puglia,45,29473,30498,59971
ITF4,Puglia,46,29149,29966,59115
ITF4,Puglia,47,29813,30716,60529
ITF4,Puglia,48,29593,30554,60147
ITF4,Puglia,49,29928,31789,61717
ITF4,Puglia,50,30032,31848,61880
ITF4,Puglia,51,30568,32079,62647
ITF4,Puglia,52,30761,32459,63220
ITF4,Puglia,53,30528,32615,63143
ITF4,Puglia,54,31041,32948,63989
ITF4,Puglia,55,28620,30838,59458
ITF4,Puglia,56,27905,30003,57908
ITF4,Puglia,57,27581,29720,57301
ITF4,Puglia,58,26888,28846,55734
ITF4,Puglia,59,26001,28356,54357
ITF4,Puglia,60,24303,27161,51464
ITF4,Puglia,61,24852,27286,52138
ITF4,Puglia,62,24089,26578,50667
ITF4,Puglia,63,23827,26312,50139
ITF4,Puglia,64,23280,25413,48693
ITF4,Puglia,65,22356,24627,46983
ITF4,Puglia,66,21409,23612,45021
ITF4,Puglia,67,22107,24312,46419
ITF4,Puglia,68,22724,25027,47751
ITF4,Puglia,69,22592,24878,47470
ITF4,Puglia,70,23569,26467,50036
ITF4,Puglia,71,22028,24739,46767
ITF4,Puglia,72,21255,24539,45794
ITF4,Puglia,73,18010,20416,38426
ITF4,Puglia,74,15838,18623,34461
ITF4,Puglia,75,15599,18459,34058
ITF4,Puglia,76,15633,18789,34422
ITF4,Puglia,77,14547,17656,32203
ITF4,Puglia,78,15449,19020,34469
ITF4,Puglia,79,14615,18824,33439
ITF4,Puglia,80,13287,17600,30887
ITF4,Puglia,81,12041,16518,28559
ITF4,Puglia,82,10647,14996,25643
ITF4,Puglia,83,10131,14590,24721
ITF4,Puglia,84,9125,13860,22985
ITF4,Puglia,85,8018,12536,20554
ITF4,Puglia,86,6997,11443,18440
ITF4,Puglia,87,6214,10486,16700
ITF4,Puglia,88,5557,9877,15434
ITF4,Puglia,89,4198,7987,12185
ITF4,Puglia,90,3407,6962,10369
ITF4,Puglia,91,2793,5997,8790
ITF4,Puglia,92,2018,4673,6691
ITF4,Puglia,93,1514,3673,5187
ITF4,Puglia,94,1117,2759,3876
ITF4,Puglia,95,815,2272,3087
ITF4,Puglia,96,592,1616,2208
ITF4,Puglia,97,374,1153,1527
ITF4,Puglia,98,242,835,1077
ITF4,Puglia,99,110,406,516
ITF4,Puglia,100 and over,179,680,859
ITF4,Puglia,Total,1934344,2041184,3975528
ITF5,Basilicata,0,1839,1817,3656
ITF5,Basilicata,1,2043,1844,3887
ITF5,Basilicata,2,2038,1941,3979
ITF5,Basilicata,3,2058,1956,4014
ITF5,Basilicata,4,2025,2010,4035
ITF5,Basilicata,5,2090,1937,4027
ITF5,Basilicata,6,2309,2105,4414
ITF5,Basilicata,7,2255,2127,4382
ITF5,Basilicata,8,2304,2205,4509
ITF5,Basilicata,9,2443,2262,4705
ITF5,Basilicata,10,2527,2322,4849
ITF5,Basilicata,11,2502,2301,4803
ITF5,Basilicata,12,2590,2376,4966
ITF5,Basilicata,13,2536,2382,4918
ITF5,Basilicata,14,2612,2623,5235
ITF5,Basilicata,15,2776,2517,5293
ITF5,Basilicata,16,2812,2633,5445
ITF5,Basilicata,17,2897,2598,5495
ITF5,Basilicata,18,3084,2684,5768
ITF5,Basilicata,19,3066,2759,5825
ITF5,Basilicata,20,3153,2672,5825
ITF5,Basilicata,21,3105,2749,5854
ITF5,Basilicata,22,3119,2775,5894
ITF5,Basilicata,23,3142,2848,5990
ITF5,Basilicata,24,3180,2961,6141
ITF5,Basilicata,25,3315,2995,6310
ITF5,Basilicata,26,3517,3258,6775
ITF5,Basilicata,27,3384,3229,6613
ITF5,Basilicata,28,3597,3284,6881
ITF5,Basilicata,29,3475,3191,6666
ITF5,Basilicata,30,3410,3222,6632
ITF5,Basilicata,31,3431,3119,6550
ITF5,Basilicata,32,3351,3079,6430
ITF5,Basilicata,33,3470,3154,6624
ITF5,Basilicata,34,3487,3254,6741
ITF5,Basilicata,35,3365,3265,6630
ITF5,Basilicata,36,3371,3342,6713
ITF5,Basilicata,37,3405,3265,6670
ITF5,Basilicata,38,3416,3247,6663
ITF5,Basilicata,39,3500,3334,6834
ITF5,Basilicata,40,3750,3496,7246
ITF5,Basilicata,41,3662,3740,7402
ITF5,Basilicata,42,4031,3874,7905
ITF5,Basilicata,43,3970,4060,8030
ITF5,Basilicata,44,4177,4048,8225
ITF5,Basilicata,45,4070,4011,8081
ITF5,Basilicata,46,4059,4215,8274
ITF5,Basilicata,47,4130,4232,8362
ITF5,Basilicata,48,4144,4343,8487
ITF5,Basilicata,49,4392,4333,8725
ITF5,Basilicata,50,4329,4447,8776
ITF5,Basilicata,51,4464,4611,9075
ITF5,Basilicata,52,4251,4537,8788
ITF5,Basilicata,53,4400,4537,8937
ITF5,Basilicata,54,4540,4706,9246
ITF5,Basilicata,55,4333,4414,8747
ITF5,Basilicata,56,4399,4447,8846
ITF5,Basilicata,57,4179,4410,8589
ITF5,Basilicata,58,4072,4362,8434
ITF5,Basilicata,59,3951,4152,8103
ITF5,Basilicata,60,3849,3974,7823
ITF5,Basilicata,61,3598,4046,7644
ITF5,Basilicata,62,3775,4004,7779
ITF5,Basilicata,63,3704,3736,7440
ITF5,Basilicata,64,3602,3853,7455
ITF5,Basilicata,65,3390,3491,6881
ITF5,Basilicata,66,3260,3507,6767
ITF5,Basilicata,67,3179,3442,6621
ITF5,Basilicata,68,3373,3483,6856
ITF5,Basilicata,69,3399,3511,6910
ITF5,Basilicata,70,3367,3704,7071
ITF5,Basilicata,71,3000,3377,6377
ITF5,Basilicata,72,2733,3057,5790
ITF5,Basilicata,73,2047,2461,4508
ITF5,Basilicata,74,2064,2329,4393
ITF5,Basilicata,75,2023,2307,4330
ITF5,Basilicata,76,1928,2380,4308
ITF5,Basilicata,77,1880,2372,4252
ITF5,Basilicata,78,2258,2706,4964
ITF5,Basilicata,79,2241,2848,5089
ITF5,Basilicata,80,2021,2705,4726
ITF5,Basilicata,81,1957,2705,4662
ITF5,Basilicata,82,1798,2481,4279
ITF5,Basilicata,83,1620,2433,4053
ITF5,Basilicata,84,1564,2380,3944
ITF5,Basilicata,85,1401,2199,3600
ITF5,Basilicata,86,1194,1885,3079
ITF5,Basilicata,87,1050,1718,2768
ITF5,Basilicata,88,954,1683,2637
ITF5,Basilicata,89,773,1375,2148
ITF5,Basilicata,90,618,1114,1732
ITF5,Basilicata,91,507,964,1471
ITF5,Basilicata,92,355,820,1175
ITF5,Basilicata,93,256,612,868
ITF5,Basilicata,94,212,443,655
ITF5,Basilicata,95,175,370,545
ITF5,Basilicata,96,114,287,401
ITF5,Basilicata,97,73,227,300
ITF5,Basilicata,98,46,119,165
ITF5,Basilicata,99,16,64,80
ITF5,Basilicata,100 and over,21,101,122
ITF5,Basilicata,Total,274697,283890,558587
ITF6,Calabria,0,7599,7190,14789
ITF6,Calabria,1,7899,7516,15415
ITF6,Calabria,2,8086,7614,15700
ITF6,Calabria,3,8190,7756,15946
ITF6,Calabria,4,8305,7752,16057
ITF6,Calabria,5,8235,7916,16151
ITF6,Calabria,6,8577,7968,16545
ITF6,Calabria,7,8661,8117,16778
ITF6,Calabria,8,8822,8487,17309
ITF6,Calabria,9,9105,8465,17570
ITF6,Calabria,10,8952,8758,17710
ITF6,Calabria,11,9181,8601,17782
ITF6,Calabria,12,9484,8807,18291
ITF6,Calabria,13,9340,8764,18104
ITF6,Calabria,14,9650,8995,18645
ITF6,Calabria,15,9679,9064,18743
ITF6,Calabria,16,9651,8921,18572
ITF6,Calabria,17,9941,9400,19341
ITF6,Calabria,18,10621,9598,20219
ITF6,Calabria,19,10782,9538,20320
ITF6,Calabria,20,10838,9846,20684
ITF6,Calabria,21,10636,9690,20326
ITF6,Calabria,22,11016,9921,20937
ITF6,Calabria,23,11012,10295,21307
ITF6,Calabria,24,11427,10437,21864
ITF6,Calabria,25,11766,11015,22781
ITF6,Calabria,26,11988,11516,23504
ITF6,Calabria,27,11950,11316,23266
ITF6,Calabria,28,12346,11544,23890
ITF6,Calabria,29,12453,11694,24147
ITF6,Calabria,30,12624,12000,24624
ITF6,Calabria,31,12251,11903,24154
ITF6,Calabria,32,12128,11648,23776
ITF6,Calabria,33,12088,11675,23763
ITF6,Calabria,34,12437,11632,24069
ITF6,Calabria,35,12190,11734,23924
ITF6,Calabria,36,12263,12097,24360
ITF6,Calabria,37,12257,12002,24259
ITF6,Calabria,38,12433,12131,24564
ITF6,Calabria,39,12514,12486,25000
ITF6,Calabria,40,12779,12553,25332
ITF6,Calabria,41,12782,13144,25926
ITF6,Calabria,42,13516,13655,27171
ITF6,Calabria,43,13457,13588,27045
ITF6,Calabria,44,13462,13898,27360
ITF6,Calabria,45,13460,13814,27274
ITF6,Calabria,46,13371,14115,27486
ITF6,Calabria,47,13520,14381,27901
ITF6,Calabria,48,13415,14230,27645
ITF6,Calabria,49,13957,15164,29121
ITF6,Calabria,50,13942,14815,28757
ITF6,Calabria,51,14058,15012,29070
ITF6,Calabria,52,13998,15126,29124
ITF6,Calabria,53,13976,14941,28917
ITF6,Calabria,54,14590,15584,30174
ITF6,Calabria,55,13794,14705,28499
ITF6,Calabria,56,13657,14729,28386
ITF6,Calabria,57,13557,14527,28084
ITF6,Calabria,58,13406,14312,27718
ITF6,Calabria,59,13099,13930,27029
ITF6,Calabria,60,12201,12940,25141
ITF6,Calabria,61,12700,13138,25838
ITF6,Calabria,62,12162,12845,25007
ITF6,Calabria,63,12098,12754,24852
ITF6,Calabria,64,12045,12561,24606
ITF6,Calabria,65,11379,11827,23206
ITF6,Calabria,66,10711,11234,21945
ITF6,Calabria,67,10835,11527,22362
ITF6,Calabria,68,11025,11691,22716
ITF6,Calabria,69,11013,11659,22672
ITF6,Calabria,70,10939,11862,22801
ITF6,Calabria,71,10619,11439,22058
ITF6,Calabria,72,9595,10506,20101
ITF6,Calabria,73,7401,8143,15544
ITF6,Calabria,74,7425,8027,15452
ITF6,Calabria,75,7059,8128,15187
ITF6,Calabria,76,6919,7986,14905
ITF6,Calabria,77,6546,7650,14196
ITF6,Calabria,78,7297,8772,16069
ITF6,Calabria,79,6935,8483,15418
ITF6,Calabria,80,6196,8120,14316
ITF6,Calabria,81,5809,7552,13361
ITF6,Calabria,82,5293,7415,12708
ITF6,Calabria,83,5095,7200,12295
ITF6,Calabria,84,4634,6733,11367
ITF6,Calabria,85,4346,6501,10847
ITF6,Calabria,86,3602,5903,9505
ITF6,Calabria,87,3091,5272,8363
ITF6,Calabria,88,2760,4788,7548
ITF6,Calabria,89,2178,3975,6153
ITF6,Calabria,90,1757,3330,5087
ITF6,Calabria,91,1340,2817,4157
ITF6,Calabria,92,1092,2368,3460
ITF6,Calabria,93,803,1888,2691
ITF6,Calabria,94,613,1510,2123
ITF6,Calabria,95,444,1140,1584
ITF6,Calabria,96,304,776,1080
ITF6,Calabria,97,193,596,789
ITF6,Calabria,98,156,439,595
ITF6,Calabria,99,49,210,259
ITF6,Calabria,100 and over,101,351,452
ITF6,Calabria,Total,937933,974088,1912021
ITG1,Sicilia,0,20191,19141,39332
ITG1,Sicilia,1,20891,19611,40502
ITG1,Sicilia,2,20766,19889,40655
ITG1,Sicilia,3,21595,20402,41997
ITG1,Sicilia,4,22103,20956,43059
ITG1,Sicilia,5,21758,20756,42514
ITG1,Sicilia,6,22805,21873,44678
ITG1,Sicilia,7,22871,21917,44788
ITG1,Sicilia,8,23617,22686,46303
ITG1,Sicilia,9,24337,23030,47367
ITG1,Sicilia,10,24706,23426,48132
ITG1,Sicilia,11,24500,23291,47791
ITG1,Sicilia,12,25370,23411,48781
ITG1,Sicilia,13,25645,24107,49752
ITG1,Sicilia,14,26086,24594,50680
ITG1,Sicilia,15,25978,24659,50637
ITG1,Sicilia,16,26126,24706,50832
ITG1,Sicilia,17,27179,25053,52232
ITG1,Sicilia,18,28801,25330,54131
ITG1,Sicilia,19,29211,26106,55317
ITG1,Sicilia,20,28454,25805,54259
ITG1,Sicilia,21,28345,25966,54311
ITG1,Sicilia,22,28323,26396,54719
ITG1,Sicilia,23,28466,26777,55243
ITG1,Sicilia,24,29205,27425,56630
ITG1,Sicilia,25,29881,28612,58493
ITG1,Sicilia,26,31058,29745,60803
ITG1,Sicilia,27,30411,29177,59588
ITG1,Sicilia,28,30605,29438,60043
ITG1,Sicilia,29,30346,29537,59883
ITG1,Sicilia,30,30505,29460,59965
ITG1,Sicilia,31,29558,28672,58230
ITG1,Sicilia,32,29543,28607,58150
ITG1,Sicilia,33,29460,29047,58507
ITG1,Sicilia,34,29904,29708,59612
ITG1,Sicilia,35,29548,29277,58825
ITG1,Sicilia,36,30383,30237,60620
ITG1,Sicilia,37,30213,30362,60575
ITG1,Sicilia,38,31369,31432,62801
ITG1,Sicilia,39,31498,31975,63473
ITG1,Sicilia,40,32473,32759,65232
ITG1,Sicilia,41,32745,33408,66153
ITG1,Sicilia,42,34474,34990,69464
ITG1,Sicilia,43,35248,35880,71128
ITG1,Sicilia,44,36231,37347,73578
ITG1,Sicilia,45,35466,36766,72232
ITG1,Sicilia,46,35584,36952,72536
ITG1,Sicilia,47,35999,38010,74009
ITG1,Sicilia,48,35483,37860,73343
ITG1,Sicilia,49,36932,38727,75659
ITG1,Sicilia,50,36293,38402,74695
ITG1,Sicilia,51,36661,38754,75415
ITG1,Sicilia,52,36248,38615,74863
ITG1,Sicilia,53,35841,38467,74308
ITG1,Sicilia,54,36958,39240,76198
ITG1,Sicilia,55,34808,37260,72068
ITG1,Sicilia,56,34445,37367,71812
ITG1,Sicilia,57,33507,36501,70008
ITG1,Sicilia,58,33364,36717,70081
ITG1,Sicilia,59,31902,34583,66485
ITG1,Sicilia,60,30649,33606,64255
ITG1,Sicilia,61,30517,33624,64141
ITG1,Sicilia,62,29653,32821,62474
ITG1,Sicilia,63,29830,32283,62113
ITG1,Sicilia,64,29082,32458,61540
ITG1,Sicilia,65,26878,29698,56576
ITG1,Sicilia,66,26415,29419,55834
ITG1,Sicilia,67,26292,28870,55162
ITG1,Sicilia,68,26826,29881,56707
ITG1,Sicilia,69,26711,30070,56781
ITG1,Sicilia,70,27466,30910,58376
ITG1,Sicilia,71,26767,30397,57164
ITG1,Sicilia,72,24069,27914,51983
ITG1,Sicilia,73,20243,23384,43627
ITG1,Sicilia,74,18993,22494,41487
ITG1,Sicilia,75,17771,21374,39145
ITG1,Sicilia,76,17104,21198,38302
ITG1,Sicilia,77,16707,21148,37855
ITG1,Sicilia,78,18433,23893,42326
ITG1,Sicilia,79,17311,22572,39883
ITG1,Sicilia,80,15803,21357,37160
ITG1,Sicilia,81,13649,18820,32469
ITG1,Sicilia,82,12758,17934,30692
ITG1,Sicilia,83,11883,17449,29332
ITG1,Sicilia,84,11142,16776,27918
ITG1,Sicilia,85,10094,15508,25602
ITG1,Sicilia,86,8228,13643,21871
ITG1,Sicilia,87,7269,12579,19848
ITG1,Sicilia,88,6664,12170,18834
ITG1,Sicilia,89,4890,9450,14340
ITG1,Sicilia,90,4034,8142,12176
ITG1,Sicilia,91,3139,6429,9568
ITG1,Sicilia,92,2412,5594,8006
ITG1,Sicilia,93,1786,4357,6143
ITG1,Sicilia,94,1329,3586,4915
ITG1,Sicilia,95,926,2477,3403
ITG1,Sicilia,96,650,1955,2605
ITG1,Sicilia,97,424,1272,1696
ITG1,Sicilia,98,267,939,1206
ITG1,Sicilia,99,129,450,579
ITG1,Sicilia,100 and over,187,790,977
ITG1,Sicilia,Total,2387653,2520895,4908548
ITG2,Sardegna,0,24927,23557,48484
ITG2,Sardegna,1,26056,24440,50496
ITG2,Sardegna,2,26157,24897,51054
ITG2,Sardegna,3,27304,25652,52956
ITG2,Sardegna,4,27903,26384,54287
ITG2,Sardegna,5,27741,26396,54137
ITG2,Sardegna,6,29136,27767,56903
ITG2,Sardegna,7,29467,28148,57615
ITG2,Sardegna,8,30476,29060,59536
ITG2,Sardegna,9,31265,29366,60631
ITG2,Sardegna,10,31554,29897,61451
ITG2,Sardegna,11,31290,29786,61076
ITG2,Sardegna,12,32330,29842,62172
ITG2,Sardegna,13,32650,30580,63230
ITG2,Sardegna,14,32971,30956,63927
ITG2,Sardegna,15,33102,31294,64396
ITG2,Sardegna,16,33062,31299,64361
ITG2,Sardegna,17,34308,31792,66100
ITG2,Sardegna,18,36389,32178,68567
ITG2,Sardegna,19,37046,32797,69843
ITG2,Sardegna,20,36113,32359,68472
ITG2,Sardegna,21,36015,32644,68659
ITG2,Sardegna,22,36160,33155,69315
ITG2,Sardegna,23,36481,33732,70213
ITG2,Sardegna,24,37233,34607,71840
ITG2,Sardegna,25,37993,36175,74168
ITG2,Sardegna,26,39520,37595,77115
ITG2,Sardegna,27,39153,37117,76270
ITG2,Sardegna,28,39550,37837,77387
ITG2,Sardegna,29,39306,37781,77087
ITG2,Sardegna,30,39491,37905,77396
ITG2,Sardegna,31,38577,37222,75799
ITG2,Sardegna,32,38508,37221,75729
ITG2,Sardegna,33,38835,37961,76796
ITG2,Sardegna,34,39515,38699,78214
ITG2,Sardegna,35,39208,38711,77919
ITG2,Sardegna,36,40696,40043,80739
ITG2,Sardegna,37,40356,40372,80728
ITG2,Sardegna,38,42134,41579,83713
ITG2,Sardegna,39,42162,42450,84612
ITG2,Sardegna,40,44303,44068,88371
ITG2,Sardegna,41,44803,44891,89694
ITG2,Sardegna,42,46876,47119,93995
ITG2,Sardegna,43,48261,48663,96924
ITG2,Sardegna,44,50029,50472,100501
ITG2,Sardegna,45,49187,49984,99171
ITG2,Sardegna,46,49056,50128,99184
ITG2,Sardegna,47,49151,51485,100636
ITG2,Sardegna,48,48721,50858,99579
ITG2,Sardegna,49,50477,52328,102805
ITG2,Sardegna,50,49318,51797,101115
ITG2,Sardegna,51,50231,52425,102656
ITG2,Sardegna,52,49826,52505,102331
ITG2,Sardegna,53,49462,52240,101702
ITG2,Sardegna,54,50824,53361,104185
ITG2,Sardegna,55,47845,50985,98830
ITG2,Sardegna,56,47159,50667,97826
ITG2,Sardegna,57,45904,49641,95545
ITG2,Sardegna,58,45579,49259,94838
ITG2,Sardegna,59,43741,46929,90670
ITG2,Sardegna,60,42246,45782,88028
ITG2,Sardegna,61,41997,45891,87888
ITG2,Sardegna,62,40912,44790,85702
ITG2,Sardegna,63,40752,43871,84623
ITG2,Sardegna,64,40167,44129,84296
ITG2,Sardegna,65,37430,40781,78211
ITG2,Sardegna,66,36712,40411,77123
ITG2,Sardegna,67,36311,39727,76038
ITG2,Sardegna,68,36935,40689,77624
ITG2,Sardegna,69,36501,40510,77011
ITG2,Sardegna,70,37245,41652,78897
ITG2,Sardegna,71,36096,40624,76720
ITG2,Sardegna,72,32847,37326,70173
ITG2,Sardegna,73,28198,32383,60581
ITG2,Sardegna,74,26607,31350,57957
ITG2,Sardegna,75,24793,30082,54875
ITG2,Sardegna,76,24289,29956,54245
ITG2,Sardegna,77,23158,29316,52474
ITG2,Sardegna,78,25408,32857,58265
ITG2,Sardegna,79,23783,30767,54550
ITG2,Sardegna,80,21343,28813,50156
ITG2,Sardegna,81,18577,25711,44288
ITG2,Sardegna,82,17370,24521,41891
ITG2,Sardegna,83,15761,23486,39247
ITG2,Sardegna,84,15095,22701,37796
ITG2,Sardegna,85,13648,21051,34699
ITG2,Sardegna,86,11171,18663,29834
ITG2,Sardegna,87,9862,16945,26807
ITG2,Sardegna,88,9033,16519,25552
ITG2,Sardegna,89,6708,13166,19874
ITG2,Sardegna,90,5545,11366,16911
ITG2,Sardegna,91,4260,9039,13299
ITG2,Sardegna,92,3375,7785,11160
ITG2,Sardegna,93,2431,5995,8426
ITG2,Sardegna,94,1830,4996,6826
ITG2,Sardegna,95,1321,3450,4771
ITG2,Sardegna,96,939,2709,3648
ITG2,Sardegna,97,597,1796,2393
ITG2,Sardegna,98,385,1353,1738
ITG2,Sardegna,99,198,672,870
ITG2,Sardegna,100 and over,276,1111,1387
ITG2,Sardegna,Total,3185005,3345800,6530805
